Exposant	Secteur	Pays	France
Railee	Hospitality/Tourism/Travel	France	France
Suzan AI	Banking/Finance/Insurance/Legal	France	France
:probabl.	Software Development/Cloud services	France	France
.lumen	Health	Romania	
·ISPALIS·	Banking/Finance/Insurance/Legal	France	France
0260.ai	Consulting	Canada	
102-103	Software Development/Cloud services	France	France
1836	Banking/Finance/Insurance/Legal	France	France
1km a pied	Smart City/Building	France	France
1POINT6	Information technologies	France	France
20 Minutes	Media/Entertainment/Culture	France	France
2CRSi	Industry	France	France
2DS LAB	Software Development/Cloud services	France	France
2Emotion	Software Development/Cloud services	France	France
2tonnes	HR/Training/Education	France	France
321	Consulting	France	France
360Learning	HR/Training/Education	France	France
365Talents	Software Development/Cloud services	France	France
36Kr	Media/Entertainment/Culture	China	
37 WINE		France	France
3D UTU	Smart City/Building	Ukraine	
4GIFT	Luxury/Fashion/Beauty	Italy	
4MedBox	Other	Netherlands	
50inTech	HR/Training/Education	France	France
62 RUBY STREET	Software Development/Cloud services	France	France
A Virtual	Consumer goods/Retail/E-commerce	South Korea	
A.V. Mapping	Media/Entertainment/Culture	Taiwan	
A2D Acquire to Decide	Software Development/Cloud services	France	France
AALIA.TECH	Health	France	France
ABAKA AI	Information technologies	Singapore	
Abilous	HR/Training/Education	France	France
ABSOLUTE LABS	Marketing/Advertising/Communication	France	France
Abundant Earth	Software Development/Cloud services	France	France
Abyssale	Marketing/Advertising/Communication	France	France
Academic Sight	Industry	Turkey	
AccesLibre	Government/Public institutions	France	France
Acclime	Consulting	Australia	
ACCURE Battery Intelligence	Software Development/Cloud services	Germany	
ACHILLE SOLUTIONS	Banking/Finance/Insurance/Legal	France	France
ACS Biotech	Health	France	France
ACSES SOLUTIONS	Other	France	France
Actronika	Other	France	France
Actronika	Other	France	France
ACTRONIKA	Other	France	France
ACTUAL GROUP	Other	France	France
ActuIA	Media/Entertainment/Culture	France	France
Acuicy	Other	Canada	
ACWA ROBOTICS	Industry	France	France
ADAM Aerospace	Cybersecurity/Defense	United States of America	
ADAPTIVE MEDIA France	HR/Training/Education	France	France
ADARA	Information technologies	Cote d’Ivoire	
ADASTEC	Software Development/Cloud services	United States of America	
AdCreative.ai	Marketing/Advertising/Communication	France	France
AddOptics	Consumer goods/Retail/E-commerce	Netherlands	
ADIM	Government/Public institutions	France	France
Adlema	Industry	Turkey	
Adriel	Software Development/Cloud services	United States of America	
Advizeo	Energy	France	France
Aectual	Other	Netherlands	
AeproMED Innovation corp.,Ltd.	Health	Taiwan	
AEQUO	Energy	France	France
AER BFC (Agence Economique Regionale Bourgogne Franche Comte)	Government/Public institutions	France	France
Aerialmetric	Industry	Madagascar	
Aeterlink Corp.	Smart City/Building	Japan	
Aevy	Energy	Norway	
AFFLUENCES	Mobility/Transportation	France	France
Africa Smart Citizen	Smart City/Building	Senegal	
Africanews	Media/Entertainment/Culture	France	France
AfricaTech Lab	Government/Public institutions	France	France
AFTERDATA	Banking/Finance/Insurance/Legal	France	France
AFTERDATA	Banking/Finance/Insurance/Legal	France	France
AFX 54	Media/Entertainment/Culture	France	France
AG Partners Publicis Africa	Media/Entertainment/Culture	France	France
AG'EAU-VITAL	Industry	France	France
AGENCE FR DE REALITE VIRTUELLE	Marketing/Advertising/Communication	France	France
Agilauto Partage	Mobility/Transportation	France	France
Aglae	Marketing/Advertising/Communication	France	France
Agnavi	Food	Japan	
Agnavi Co. Ltd.,	Food	Japan	
Agnostiq	Software Development/Cloud services	Canada	
Agorize	Information technologies	France	France
Agrable	Banking/Finance/Insurance/Legal	France	France
AGRI LAB LEVERAGE	Food	France	France
Agribanana	Industry	Cote d’Ivoire	
agriBORA	Food	Kenya	
AGRILOGIC SYSTeMES	Industry	New Caledonia	
AgroSustain	Food	Switzerland	
Agua de Sol SAS	Food	France	France
aHRtemis	HR/Training/Education	France	France
AI Avenue sponsored by Salesforce	Software Development/Cloud services	France	France
AI Bright	Consumer goods/Retail/E-commerce	France	France
AI BRIGHT	Consumer goods/Retail/E-commerce	France	France
AI for Biogas	Energy	France	France
AI SILK Corporation	Industry	Japan	
AI21 Labs	Software Development/Cloud services	Israel	
AI4MedImaging	Software Development/Cloud services	Portugal	
Ai4Privacy	Telecom/Connectivity	Switzerland	
AiiNTENSE	Health	France	France
Ailive Inc.	Software Development/Cloud services	South Korea	
AILY LABS	Software Development/Cloud services	Germany	
AIMEDIS	Health	Netherlands	
Aimino Tech GmbH	Software Development/Cloud services	Germany	
AIMMO	Software Development/Cloud services	South Korea	
AINDO SPA	Information technologies	Italy	
AIPS Technology Co., Ltd.	Other	Taiwan	
AIRA Corporation	Smart City/Building	Taiwan	
Airalo	Hospitality/Tourism/Travel	Singapore	
Airbus	Mobility/Transportation	France	France
Aircards & Metalitix	Consumer goods/Retail/E-commerce	United Kingdom	
AIRMO	Energy	Germany	
Airrange Software GmbH	Software Development/Cloud services	Germany	
Airtel	Telecom/Connectivity	Congo, the Democratic Republic	
Airudi	HR/Training/Education	Canada	
Airudit	Software Development/Cloud services	France	France
Airwallex	Software Development/Cloud services	Australia	
AISTROSPACE	Information technologies	United Arab Emirates	
Aitenders	Software Development/Cloud services	France	France
Aive	Marketing/Advertising/Communication	France	France
AiVidens	Information technologies	Belgium	
AIZoPlan powered by iTransform365	Information technologies	France	France
AKANTHAS	Smart City/Building	France	France
AKIDAIA	Cybersecurity/Defense	France	France
Ako	Luxury/Fashion/Beauty	France	France
ALBERT IA	Government/Public institutions	France	France
Alchimedics	Health	France	France
Alcmeon	Software Development/Cloud services	France	France
Aldoria	Industry	France	France
ALEIA	Information technologies	France	France
Alemca	Industry	France	France
Algal Bio	Industry	Japan	
Algerian Startups Fund	Banking/Finance/Insurance/Legal	Algeria	
Algoritmi	Hospitality/Tourism/Travel	Japan	
ALGOS	Software Development/Cloud services	France	France
AlgoTech	Health	France	France
Alibaba Cloud	Software Development/Cloud services	China	
Alice & Bob	Information technologies	France	France
ALICE & BOB	Information technologies	France	France
Aligo AI	Marketing/Advertising/Communication	South Korea	
ALIOTHSYSTEM ENERGY	Energy	Burkina Faso	
All Good Energy Co., Ltd.	Energy	Taiwan	
Alliance Industrie du Futur	Non Profit	France	France
AlloBrain		France	France
AlloReview	Information technologies	France	France
Alltheway	Software Development/Cloud services	France	France
Allye Energy	Energy	United Kingdom	
Alp Valley	Information technologies	France	France
ALPAY	Banking/Finance/Insurance/Legal	Algeria	
Alpha Recyclage Composites	Industry	France	France
ALPHA10X	Banking/Finance/Insurance/Legal	France	France
Alphabrain	Health	France	France
Alphabrain	Health	France	France
Altametris	Software Development/Cloud services	France	France
Alterande	Industry	France	France
ALTEVAX	Health	France	France
ALTRANS Energies	Energy	France	France
ALTYOR - STRATOS : MAKE IT! ACADEMY	Industry	France	France
Always Support Technology Co., Ltd	Software Development/Cloud services	Taiwan	
AM3L	Industry	France	France
AMATELUS Inc.	Media/Entertainment/Culture	Japan	
Amazon Web Services (AWS)	Software Development/Cloud services	United States of America	
AMD Products (China)Co.,Ltd.	Consumer goods/Retail/E-commerce	China	
Amiral Technologies	Industry	France	France
AMK biotech	Health	France	France
AMK Biotech	Health	France	France
Amon AI	Smart City/Building	France	France
AMPECO	Mobility/Transportation	Bulgaria	
AMPHITRITE	Mobility/Transportation	France	France
amplify	Marketing/Advertising/Communication	Switzerland	
ANAE	Government/Public institutions	France	France
ANALOGIES	Health	France	France
ANAPIX medical	Health	France	France
Anavid	Consumer goods/Retail/E-commerce	France	France
anessa	Energy	Canada	
ANFR	Government/Public institutions	France	France
Angel	Software Development/Cloud services	France	France
Angel-start	Software Development/Cloud services	France	France
Anod	Mobility/Transportation	France	France
Anozr Way	Cybersecurity/Defense	France	France
Anthropic	Information technologies	United States of America	
Antilogy	Consulting	France	France
ANYOS	Mobility/Transportation	France	France
Anywr	HR/Training/Education	France	France
AP solution IO	Software Development/Cloud services	France	France
APGAR	Consulting	France	France
AppTweak	Marketing/Advertising/Communication	Belgium	
AQEMIA	Health	France	France
AQEMIA	Health	France	France
AquaTech Innovation	Industry	France	France
AR Engineering	Software Development/Cloud services	United Arab Emirates	
AR[t] Studio	Media/Entertainment/Culture	France	France
Arbiom	Food	France	France
Arcadium esport	Media/Entertainment/Culture	France	France
Archillys	Luxury/Fashion/Beauty	Japan	
ARCHIMAID	Smart City/Building	France	France
Archireef	Other	Hong Kong	
Archireef	Other	United Arab Emirates	
Areix Analytics Limited	Information technologies	Taiwan	
ARGO	Marketing/Advertising/Communication	France	France
Arianee	Information technologies	France	France
Ark Wisdom Co., Ltd.	Media/Entertainment/Culture	Taiwan	
Armada	Media/Entertainment/Culture	France	France
ARMENIA - Ministry of High-Tech Industry	Government/Public institutions	Armenia	
ARPINET LLC	Telecom/Connectivity	Armenia	
Art Confidential	Media/Entertainment/Culture	France	France
Art&Fact Innovation	Telecom/Connectivity	France	France
ART&FACT INNOVATION	Telecom/Connectivity	France	France
ARTCENTRICA	Media/Entertainment/Culture	Italy	
arTech	Media/Entertainment/Culture	Guadeloupe	
Artefact	Consulting	France	France
Artefact Open Innovation	Consulting	France	France
Article 1	HR/Training/Education	France	France
Artifeel	Smart City/Building	France	France
Artifeel	Smart City/Building	France	France
ArtinLeap	Information technologies	France	France
ARTKOFA	Marketing/Advertising/Communication	France	France
Artpoint	Media/Entertainment/Culture	France	France
Arxy Future Lab s.a.r.l	Luxury/Fashion/Beauty	Luxembourg	
ARY	Consumer goods/Retail/E-commerce	France	France
Aryballe	Industry	France	France
ASE AG	Mobility/Transportation	Switzerland	
Ask for the moon	Software Development/Cloud services	France	France
Asleep	Health	korearepublicof	
ASphere	HR/Training/Education	France	France
Aster-X	Software Development/Cloud services	France	France
Astha IT	Software Development/Cloud services	Bangladesh	
ASTRAKODE SRL	Software Development/Cloud services	Italy	
ASTRAN	Cybersecurity/Defense	France	France
Astreas	Food	United States of America	
ASTRIIS	Industry	France	France
asvin GmbH	Cybersecurity/Defense	Germany	
ateka|tx	Health	France	France
Atekka	Banking/Finance/Insurance/Legal	France	France
ATHICS	Information technologies	Italy	
AtmosGear	Consumer goods/Retail/E-commerce	France	France
ATOFLOW	Media/Entertainment/Culture	New Caledonia	
Atopia	Media/Entertainment/Culture	Germany	
Atoptima	Software Development/Cloud services	France	France
Au-Zone Technologies	Mobility/Transportation	Canada	
Audi	Mobility/Transportation	Germany	
AUDIO GUIDE PARIS	Hospitality/Tourism/Travel	France	France
Augmented Brain Labs SA	Information technologies	Switzerland	
Augur	Industry	France	France
AUMET	Software Development/Cloud services	France	France
AURIZEO	Mobility/Transportation	France	France
AUSHA	Marketing/Advertising/Communication	France	France
Australia - Global Victoria	Government/Public institutions	Australia	
Authena	Information technologies	Switzerland	
AutoLex	Software Development/Cloud services	France	France
Automatika	Software Development/Cloud services	France	France
Autone	Software Development/Cloud services	France	France
AUTONOMOUS	Information technologies	Saudi Arabia	
AUUM	Industry	France	France
Ava Group	Industry	Australia	
Avalanche Computing Taiwan Inc.	Information technologies	Taiwan	
AVATAR MEDICAL	Health	France	France
AVAtronics SA	Other	Switzerland	
AVES Reality	Cybersecurity/Defense	Germany	
AVES Reality	Mobility/Transportation	Germany	
AVOB	Smart City/Building	France	France
AvoLingo	HR/Training/Education	Germany	
AVOMO VR	Media/Entertainment/Culture	France	France
AWIT	Software Development/Cloud services	Belgium	
AWorld	Information technologies	Italy	
AXA	Banking/Finance/Insurance/Legal	France	France
Axelera AI	Information technologies	Netherlands	
Axionable	Consulting	France	France
Axys	Consulting	France	France
Aydee	Luxury/Fashion/Beauty	France	France
Aywajieune	Consumer goods/Retail/E-commerce	Senegal	
B in Touch	Information technologies	France	France
b4value.net GmbH	Information technologies	Germany	
Baamtu	Software Development/Cloud services	Senegal	
Baback	Consumer goods/Retail/E-commerce	France	France
Bactech	Cybersecurity/Defense	France	France
Bamboo Energy	Energy	Spain	
Bambuser	Software Development/Cloud services	Sweden	
BARC	Consumer goods/Retail/E-commerce	South Korea	
Barreleye Inc.	Health	korearepublicof	
Barunbio Inc.	Luxury/Fashion/Beauty	South Korea	
BaseGun	Cybersecurity/Defense	France	France
Batazia	Information technologies	Netherlands	
Batch	Marketing/Advertising/Communication	France	France
Batiprint3D	Industry	France	France
BAVARDISES	Personal Services	France	France
Bavarian Startups	Government/Public institutions	Germany	
BAVERTIS	Mobility/Transportation	Germany	
BE ENERGY	Energy	France	France
Beam AI	Information technologies	Germany	
Beam for music (Atrack)	Media/Entertainment/Culture	France	France
BearingPoint	Consulting	France	France
BEATERS	Luxury/Fashion/Beauty	France	France
Beaunex Co., Ltd.	Luxury/Fashion/Beauty	korearepublicof	
Beaute INeE	Luxury/Fashion/Beauty	France	France
BEEKAST	Other	France	France
Beekee sarl	HR/Training/Education	Switzerland	
BeePlanet	Energy	Spain	
Beesiha	Health	Algeria	
BeestrÓ My French Paille a Croquer	Food	France	France
Beev	Mobility/Transportation	France	France
BEEWANT	Information technologies	France	France
Beeway LMI	Mobility/Transportation	France	France
BeFC	Energy	France	France
BEFC	Energy	France	France
BEHAV	Industry	France	France
BEINK DREAM	Software Development/Cloud services	France	France
Belgium	Government/Public institutions	Belgium	
Bellwether Industries	Mobility/Transportation	United Kingdom	
Bercy Hub	Government/Public institutions	France	France
Beslogic	Information technologies	Canada	
Best Influence	Marketing/Advertising/Communication	France	France
BestCase by ZWS GmbH	Software Development/Cloud services	Germany	
Beta.gouv.fr	Government/Public institutions	France	France
BEWAI	Software Development/Cloud services	France	France
BEWELLCOME	Health	France	France
BeZero Carbon	Information technologies	United Kingdom	
BFM Business	Media/Entertainment/Culture	France	France
BHOUT	Consumer goods/Retail/E-commerce	Portugal	
BHOUT	Consumer goods/Retail/E-commerce	Portugal	
Bia	Energy	Spain	
Bianor Group	Software Development/Cloud services	Bulgaria	
Bib batteries	Mobility/Transportation	France	France
BIC - Business & Innovation Centre	Government/Public institutions	France	France
Bifrost AI	Software Development/Cloud services	United States of America	
Bigbro.ai	Information technologies	United States of America	
BigProfiles	Software Development/Cloud services	Italy	
Bike Explo	Hospitality/Tourism/Travel	France	France
Billiv	Consumer goods/Retail/E-commerce	France	France
BIM FLOW	Smart City/Building	Tunisia	
BIMP	Software Development/Cloud services	Ukraine	
Binoloop	Information technologies	Canada	
BIOHAP	Industry	France	France
Biomede	Food	France	France
Biomemory	Software Development/Cloud services	France	France
Biometrid	Information technologies	Portugal	
BIOMITECH	Smart City/Building	France	France
Biomyc	Consumer goods/Retail/E-commerce	Bulgaria	
BIONIRS	Health	Argentina	
Bioptimus	Health	France	France
BIOSOLVIT INDUSTRIA E COMeRCIO	Industry	Brazil	
Bioteos	Smart City/Building	France	France
Biped	Health	Switzerland	
BIS - BUILDING INNOVATION SYSTEM	Smart City/Building	France	France
Bistrochat	Hospitality/Tourism/Travel	Hong Kong	
BJIT LIMITED	Software Development/Cloud services	Bangladesh	
BK Fire	Other	Algeria	
BK ROBOTRONICS	Other	Algeria	
Black Fire ______	Industry	China	
Black Forest AI GmbH	Information technologies	Germany	
black-line	Other	France	France
Blackfoot	Information technologies	France	France
Blacknut Cloud Gaming	Media/Entertainment/Culture	France	France
blackshark.ai	Other	Austria	
Blade Sense	Energy	France	France
Blank	Banking/Finance/Insurance/Legal	France	France
BLINK SOLUTION	Banking/Finance/Insurance/Legal	Algeria	
BLNG	Software Development/Cloud services	United States of America	
BLOKKUS	Cybersecurity/Defense	France	France
Bloomflow	Software Development/Cloud services	France	France
bloomUp	Consulting	Switzerland	
Blue Bees Therapeutics	Health	France	France
Blue Frog Robotics	Other	France	France
Blue Sky Energy Technology	Smart City/Building	Hong Kong	
Bluecrux	Information technologies	Belgium	
BLUENOSE	Industry	France	France
BNP PARIBAS	Banking/Finance/Insurance/Legal	France	France
Board of Cyber	Cybersecurity/Defense	France	France
bodih	HR/Training/Education	France	France
Bodyguard	Software Development/Cloud services	France	France
Bolt Insight	Marketing/Advertising/Communication	Turkey	
BON VIVANT	Food	France	France
Bondstein Technologies Limited	Information technologies	Bangladesh	
BOOKBOOKSHOP	HR/Training/Education	Cameroon	
Bordeaux Metropole	Government/Public institutions	France	France
Borui	Marketing/Advertising/Communication	France	France
BOUDI	Industry	France	France
BOUYGUES	Smart City/Building	France	France
BoxUp	Health	Switzerland	
BPartners IA	Software Development/Cloud services	France	France
Bpifrance	Banking/Finance/Insurance/Legal	France	France
Brain Station 23 PLC.	Software Development/Cloud services	Bangladesh	
Brain.	Cybersecurity/Defense	France	France
Brain4Data	Information technologies	Germany	
BrainBox AI	Smart City/Building	Canada	
BrainBox AI	Energy	Canada	
Braincube	Software Development/Cloud services	France	France
Brainfinger	Information technologies	France	France
Braintale	Health	France	France
BRANPER	Information technologies	Tunisia	
Bria Generative AI	Software Development/Cloud services	Israel	
Bria.ai	Software Development/Cloud services	United States of America	
BRIGHT	Marketing/Advertising/Communication	France	France
British Embassy in Paris - UK Pavilion	Government/Public institutions	United Kingdom	
Bryanthings	Luxury/Fashion/Beauty	France	France
BRYANTHINGS	Luxury/Fashion/Beauty	France	France
bsurance	Banking/Finance/Insurance/Legal	Austria	
BT	Telecom/Connectivity	United Kingdom	
Builder.ai	Software Development/Cloud services	United Kingdom	
Bulgarian SME Promotion Agency	Government/Public institutions	Bulgaria	
Bunka	Software Development/Cloud services	France	France
Business France	Government/Public institutions	France	France
Business France - Innovation Outre-Mer	Government/Public institutions	France	France
Business Insider	Media/Entertainment/Culture	United States of America	
Buster.Ai	Cybersecurity/Defense	France	France
Butterfly XR	Health	France	France
Button Hop	Software Development/Cloud services	France	France
BYD FRANCE	Mobility/Transportation	France	France
Bye Blues	Health	France	France
BYOME LABS	Luxury/Fashion/Beauty	France	France
BYSCO	Industry	France	France
BZHunt	Cybersecurity/Defense	France	France
C.S.T - Crime Science Technology	Cybersecurity/Defense	France	France
C12	Information technologies	France	France
C2MI		Canada	
Caast	Marketing/Advertising/Communication	France	France
Cabinet Office / Government of Japan	Other	Japan	
CAIMI	Health	South Korea	
CALINESCENCE	Health	France	France
Callendar	Industry	France	France
Calypso AI	Information technologies	United States of America	
CAMION	Mobility/Transportation	Saudi Arabia	
Campus Cyber	Cybersecurity/Defense	France	France
Camunda	Software Development/Cloud services	Germany	
Canada - Ambassade du Canada	Government/Public institutions	Canada	
Candam	Smart City/Building	Spain	
Caona Health	Health	Germany	
Cape	Cybersecurity/Defense	France	France
CAPFLOW	Smart City/Building	Belgium	
CAPGEMINI	Consulting	France	France
CAPSUL EVENTS	Marketing/Advertising/Communication	France	France
Capsule Corp Labs			
Captain Blink	Mobility/Transportation	France	France
CapTop S.r.l.	Energy	Italy	
CARAVEL By ImageImages	Hospitality/Tourism/Travel	France	France
Carbon Energy. Inc	Energy	korearepublicof	
CarboneIO	Software Development/Cloud services	France	France
Carbonplace	Software Development/Cloud services	United Kingdom	
CarbonScore	Software Development/Cloud services	France	France
CareU	Health	Taiwan	
CARTOBIO	Government/Public institutions	France	France
CartoDEBAT	Other	France	France
Cassava Technologies	Telecom/Connectivity	United Kingdom	
CATALARM	Mobility/Transportation	France	France
CAYTU	Software Development/Cloud services	Senegal	
CB NEWS	Media/Entertainment/Culture	France	France
CCB GREENTECH	Industry	France	France
CCI Paris Ile-de-France	Government/Public institutions	France	France
CDOCCAZ	Consumer goods/Retail/E-commerce	France	France
CEA	Government/Public institutions	France	France
Ceercle	Consumer goods/Retail/E-commerce	France	France
CEIA - AI Center of Excellence	HR/Training/Education	Brazil	
CEiSCAT	Health	France	France
CELLAVEN	Other	France	France
CellEmax	Health	France	France
CellEmax	Health	France	France
CENTILOC	Industry	France	France
CentML	Software Development/Cloud services	Canada	
Centurio Esport	Media/Entertainment/Culture	France	France
Cerenyi.ai	Information technologies	Canada	
Cereus Biosciences	Health	France	France
Certainty Compliance	Consulting	Australia	
Cezigue	Mobility/Transportation	France	France
Chainote	Banking/Finance/Insurance/Legal	France	France
Chambre Franco-Allemande de Commerce et d'Industrie	Government/Public institutions	France	France
Changing Dot	Software Development/Cloud services	France	France
Chari	Banking/Finance/Insurance/Legal	Morocco	
Chat Legal.AI	Software Development/Cloud services	France	France
Chata.ai	Information technologies	Canada	
ChatFAQ	Information technologies	Spain	
ChatLabs	Luxury/Fashion/Beauty	United States of America	
Chatlicense	Media/Entertainment/Culture	Netherlands	
Check & Visit	Smart City/Building	France	France
CHINA EXPO	Other	France	France
China Pavilion ___	Government/Public institutions	China	
CHIRON	Marketing/Advertising/Communication	Reunion	
CHITOSE	Industry	Japan	
Choose France	Government/Public institutions	France	France
Choose Paris Region	Non Profit	France	France
CHOUETTE	Other	France	France
CHRISAYA - ESPRIT LeGER	Luxury/Fashion/Beauty	France	France
CIC	Banking/Finance/Insurance/Legal	France	France
CIRCLE	Mobility/Transportation	France	France
Circu Li-ion S.A	Energy	Luxembourg	
CIRCUL'EGG	Food	France	France
Circulae	Banking/Finance/Insurance/Legal	France	France
CircularPlace	Software Development/Cloud services	France	France
CircularPlace	Software Development/Cloud services	France	France
Citadel AI Inc.	Software Development/Cloud services	Japan	
Citronics	Information technologies	Belgium	
City of Dusseldorf, Office of Economic Development	Government/Public institutions	Germany	
Clarinox	Software Development/Cloud services	Australia	
CLASSQUIZ	HR/Training/Education	Tunisia	
clavata Inc.	Consumer goods/Retail/E-commerce	korearepublicof	
CleanMob	Mobility/Transportation	France	France
Cleed.ai	Consumer goods/Retail/E-commerce	France	France
CLEM'	Mobility/Transportation	France	France
Clever Cloud	Software Development/Cloud services	France	France
CleverValues	Software Development/Cloud services	France	France
Cleyrop	Software Development/Cloud services	France	France
Cleyrop	Software Development/Cloud services	France	France
Clhynn	Energy	France	France
CLICK THERAPEUTICS	Health	United States of America	
clikOdoc	Health	France	France
Climate Standard	Other	Italy	
ClimateCamp	Information technologies	Luxembourg	
Climbo	Marketing/Advertising/Communication	Italy	
Climeet	Other	France	France
Clinic Home	Health	Cameroon	
ClipFix	Other	Armenia	
Cloud Data Engine	Software Development/Cloud services	France	France
Cloud Data Engine	Software Development/Cloud services	France	France
Cloud Inspire	Software Development/Cloud services	France	France
CMA - CGM	Mobility/Transportation	France	France
CNBC	Media/Entertainment/Culture	United States of America	
CNN	Media/Entertainment/Culture	United States of America	
CNRS	Other	France	France
CO2BioClean GmbH	Industry	Germany	
Coachello	HR/Training/Education	France	France
CoAudit GROUP	Software Development/Cloud services	France	France
COBOD	Smart City/Building	Denmark	
COCOLIS	Mobility/Transportation	France	France
Cocoparks'	Mobility/Transportation	France	France
Codalio	Software Development/Cloud services	Canada	
Code du Travail Numerique	Government/Public institutions	France	France
Codery	Software Development/Cloud services	Bulgaria	
codoc	Health	France	France
COEUR-NET	Cybersecurity/Defense	France	France
CogNeed	Software Development/Cloud services	France	France
Cognixion	Health	United States of America	
Cohort	Consumer goods/Retail/E-commerce	France	France
COLIBA AFRICA	Other	Cote d’Ivoire	
ColibriTD	Information technologies	France	France
COLINE CARE	HR/Training/Education	France	France
Collectivite de Corse I Agence de Developpement Economique de la Corse (ADEC)	Other	France	France
COLORFOL	Media/Entertainment/Culture	Cameroon	
COMET	Information technologies	France	France
COMEXI	Industry	Spain	
COMIN	Mobility/Transportation	France	France
Commissariat General au Developpement Durable	Government/Public institutions	France	France
Commown	Information technologies	France	France
Commute Zen (WeavAir company)	Information technologies	Singapore	
COMPL'ALIM	Food	France	France
ComplyMarket	Information technologies	Germany	
COMPOROLL	Food	Tunisia	
Compredict	Software Development/Cloud services	Germany	
Compusave	Telecom/Connectivity	Algeria	
Concours Mines-Telecom	HR/Training/Education	France	France
Concree	Software Development/Cloud services	Senegal	
Configreality Technology Limited	Media/Entertainment/Culture	China	
Connected Cycle	Mobility/Transportation	France	France
Connectedrealities	Software Development/Cloud services	Poland	
Contents.com	Information technologies	Italy	
Contentsquare	Software Development/Cloud services	France	France
Coomtech Ltd	Industry	United Kingdom	
Coreod Space	Software Development/Cloud services	France	France
Cortex Machina SRL	Health	Belgium	
Cosmian	Software Development/Cloud services	France	France
COSMO CONNECTED	Mobility/Transportation	France	France
Cosmo Tech	Software Development/Cloud services	France	France
Counterfake AI	Consumer goods/Retail/E-commerce	Turkey	
Covoiturage	Mobility/Transportation	France	France
Coyali	Telecom/Connectivity	France	France
COZERO	Software Development/Cloud services	Germany	
Craftsmen - Software Maestros.	Software Development/Cloud services	Bangladesh	
CREAGUM	Industry	France	France
Credit Agricole	Banking/Finance/Insurance/Legal	France	France
CREFLE Inc.	Software Development/Cloud services	South Korea	
CrossCall	Consumer goods/Retail/E-commerce	France	France
Crowdaa	Software Development/Cloud services	Reunion	
Crowdworks AI	Information technologies	South Korea	
CryoCollect SAS	Energy	France	France
CryptoNext Security	Cybersecurity/Defense	France	France
CRYSTALCHAIN	Information technologies	France	France
CSEM SA	Other	Switzerland	
csky.ai	Information technologies	Switzerland	
CultTech Association	Media/Entertainment/Culture	Austria	
CULTURADVISOR	Media/Entertainment/Culture	France	France
Culture pieces	Media/Entertainment/Culture	China	
Culturius	Media/Entertainment/Culture	Belgium	
Cuoncrop	Food	Japan	
CURE51	Health	France	France
CureCurve Medical AI	Health	Germany	
CustomsBridge	Information technologies	France	France
cvnavi ______	Industry	China	
CWS Platform	Software Development/Cloud services	Brazil	
CYBELETECH	Other	France	France
CYBERSHEN	Cybersecurity/Defense	France	France
CYBERTEC SERVICES S.R.L./COMPUTARTE	Smart City/Building	Italy	
Cybertron Tech GmbH ________	Industry	China	
Cynteract GmbH	Health	Germany	
CypherLab	Information technologies	France	France
Cypien AI	Information technologies	Turkey	
D-Shape Limited	Smart City/Building	Hong Kong	
DABIDA Corp.	Smart City/Building	South Korea	
DAIDALA	Media/Entertainment/Culture	France	France
Daily Deal	Health	Algeria	
Dailymotion Pro	Media/Entertainment/Culture	France	France
Dartfish	Software Development/Cloud services	Switzerland	
Data Driven	HR/Training/Education	France	France
Data farms	Food	Canada	
Data First Solutions	Information technologies	United Arab Emirates	
Data for Ethic	HR/Training/Education	France	France
Data Green by Netsooon.AI	Software Development/Cloud services	France	France
Data Monsters	Consumer goods/Retail/E-commerce	South Korea	
Data protect	Cybersecurity/Defense	France	France
DataBeez	HR/Training/Education	Senegal	
DataGalaxy	Software Development/Cloud services	France	France
Dataiku	Software Development/Cloud services	France	France
Dataiku	Software Development/Cloud services	France	France
Datapred	Software Development/Cloud services	France	France
Datategy	Software Development/Cloud services	France	France
DAVI	Software Development/Cloud services	France	France
Dawex	Information technologies	France	France
Daylindo	HR/Training/Education	France	France
de:hub digital ecosystems	Government/Public institutions	Germany	
Dealt	Consumer goods/Retail/E-commerce	France	France
Deardot	Luxury/Fashion/Beauty	South Korea	
DeclareDouane	Government/Public institutions	France	France
Deep Life	Health	France	France
DEEP.FINE	Software Development/Cloud services	South Korea	
DeepHawk	Industry	France	France
DeepHawk	Industry	France	France
Deepixel	Luxury/Fashion/Beauty	South Korea	
Deepomatic	Software Development/Cloud services	France	France
DeepScent Inc.	Smart City/Building	korearepublicof	
Deeptimize	Software Development/Cloud services	France	France
Deesup	Consumer goods/Retail/E-commerce	Italy	
Deki	Mobility/Transportation	France	France
Delarto	Information technologies	Bulgaria	
Deloitte	Consulting	France	France
DELOITTE AFRICA	Consulting	Tunisia	
Delos Intelligence	Software Development/Cloud services	France	France
DELPHINE GENIN - Virtual Atelier	Luxury/Fashion/Beauty	Australia	
deltaVision GmbH	Industry	Germany	
DeltaWave	Health	France	France
DELUPAY	Banking/Finance/Insurance/Legal	France	France
DemandHigh	Marketing/Advertising/Communication	Bulgaria	
Demet Air	Smart City/Building	France	France
DEMREA FRANCE	Smart City/Building	France	France
DENERGIUM	Software Development/Cloud services	France	France
Depist&vous	Health	France	France
DePlano	Banking/Finance/Insurance/Legal	France	France
Design system de l'etat français	Government/Public institutions	France	France
deskbird	Software Development/Cloud services	Switzerland	
DESMO PTE.LTD.	Smart City/Building	Singapore	
Deus Robotics	Software Development/Cloud services	United States of America	
Deutsch-Französische Hochschule / Universite franco-allemande (DFH-UFA)	HR/Training/Education	Germany	
Deutsches Forschungszentrum für Künstliche Intelligenz DFKI	Information technologies	Germany	
Devana	Software Development/Cloud services	France	France
Devanthro	Health	Germany	
Dexter	Energy	Netherlands	
Dextrain	Health	France	France
DFI	Marketing/Advertising/Communication	France	France
DGDDI -3D	Government/Public institutions	France	France
DGSE	Government/Public institutions	France	France
DiaDeep	Health	France	France
Diagante	Health	France	France
DIAGANTE	Health	France	France
Diagoriente	Government/Public institutions	France	France
Diagrams technologies	Software Development/Cloud services	France	France
DiagRAMS Technologies	Software Development/Cloud services	France	France
DIAM CONCEPT	Luxury/Fashion/Beauty	France	France
DIAMSENS	Consumer goods/Retail/E-commerce	France	France
Didask	HR/Training/Education	France	France
DIGIBARRE	Information technologies	New Caledonia	
Digital Bangladesh	Government/Public institutions	Bangladesh	
DIGITAL PROGRAM FOR ADHD FAMILIES	Health	France	France
Digital Substrate	Information technologies	France	France
DIGITALANDMARKS	Marketing/Advertising/Communication	France	France
Digiteal	Banking/Finance/Insurance/Legal	Belgium	
DinMo	Software Development/Cloud services	France	France
Dionymer	Industry	France	France
Direction de la Transformation Numerique du ministere de l’Interieur et des Outre-mer	Other	France	France
Direction du Numerique du ministere du Travail, de la Sante et des Solidarites	Government/Public institutions	France	France
Direction generale de l’administration et de la fonction publique	Government/Public institutions	France	France
Direction interministerielle de la Transformation publique	Government/Public institutions	France	France
Direction interministerielle du Numerique (DINUM)	Government/Public institutions	France	France
Discuss&Care	Health	France	France
Djamo	Banking/Finance/Insurance/Legal	Cote d’Ivoire	
Djoli	Consumer goods/Retail/E-commerce	Cote d’Ivoire	
DK	Marketing/Advertising/Communication	France	France
DLM Soft	Information technologies	France	France
DNC Information Management GmbH	Software Development/Cloud services	Germany	
Docent	Media/Entertainment/Culture	France	France
Docusign	Information technologies	France	France
Domethics srl	Health	Italy	
Domifa	Government/Public institutions	France	France
Dongguan Yuanguan Technology Co Ltd	Industry	China	
Dopavision	Health	Germany	
DossierFacile	Government/Public institutions	France	France
Douzzie	HR/Training/Education	France	France
DPEProd	Information technologies	France	France
DRACOSS	Energy	Tunisia	
Draft & Goal	Software Development/Cloud services	Canada	
Dreaminzzz	Health	France	France
DRESSX	Luxury/Fashion/Beauty	United States of America	
DriiveMe	Mobility/Transportation	France	France
Drilllight	Health	France	France
DROIMAGE	Marketing/Advertising/Communication	France	France
DroMii Co., Ltd.	Information technologies	South Korea	
Droople	Smart City/Building	Switzerland	
DS PERFORMANCE	Mobility/Transportation	France	France
DSG.AI	Banking/Finance/Insurance/Legal	Germany	
DT Master Carbon	Software Development/Cloud services	France	France
Dubai Department of Economy and Tourism	Government/Public institutions	United Arab Emirates	
DUCKMA SRL	Software Development/Cloud services	Italy	
DUKE	Software Development/Cloud services	Reunion	
DUST	Information technologies	France	France
DWS	Luxury/Fashion/Beauty	France	France
Dydu	Telecom/Connectivity	France	France
Dyjest	Health	France	France
Dynamo S.p.A	Information technologies	Italy	
e-BMDC	Cybersecurity/Defense	France	France
Earthian AI	Banking/Finance/Insurance/Legal	Netherlands	
EASY PEASY INSURTECH	Banking/Finance/Insurance/Legal	Ukraine	
EasyDMARC	Cybersecurity/Defense	Armenia	
EBIOSE	Information technologies	France	France
Ecal	Media/Entertainment/Culture	Australia	
EcoBarter	Other	Nigeria	
Ecohesens	Health	France	France
ecole des dirigeants HEC Montreal	Government/Public institutions	Canada	
ecollant	Industry	France	France
Ecomesure	Information technologies	France	France
EcoNautik	Mobility/Transportation	France	France
ECTOR	Hospitality/Tourism/Travel	France	France
EDF	Energy	France	France
Edgeless Systems	Cybersecurity/Defense	Germany	
Edhec Entrepreneurs	Other	France	France
EDMAPS	Information technologies	Ukraine	
EDONIA	Food	France	France
EF Polymer K.K.	Industry	Japan	
Effa	Consumer goods/Retail/E-commerce	United States of America	
Effixis	Consulting	Belgium	
EFPolymer	Industry	Japan	
Egonym	Information technologies	Switzerland	
EHLeague, Hotels Club by TiCATi.com	Hospitality/Tourism/Travel	France	France
EHP2	Mobility/Transportation	France	France
eiicon co.,ltd	Other	Japan	
EIKO	Non Profit	France	France
EISOX	Smart City/Building	France	France
Ekimetrics	Information technologies	France	France
Ekimetrics	Information technologies	France	France
EKLEER	Information technologies	South Korea	
ELA Innovation	Information technologies	France	France
ELDA TECHNOLOGY	Software Development/Cloud services	France	France
Electra	Mobility/Transportation	France	France
electric Oasis	Mobility/Transportation	France	France
Electrochaea GmbH	Energy	Germany	
Elementag	Industry	Italy	
Elephantech Inc.	Industry	Japan	
Elikya Therapeutics	Health	France	France
ELIO SAS	HR/Training/Education	France	France
Eliq	Energy	Sweden	
Elixir Health	Health	France	France
Ellipse	Industry	United States of America	
Elona Health	Health	Germany	
elow	Energy	France	France
Elpyoo	HR/Training/Education	France	France
Elysium Lab	Banking/Finance/Insurance/Legal	Switzerland	
Embassy of Brazil in Paris	Government/Public institutions	Brazil	
Embie	Software Development/Cloud services	Belgium	
EMCT CO., LTD.	Software Development/Cloud services	South Korea	
Emocio	HR/Training/Education	France	France
Emperia	Software Development/Cloud services	United Kingdom	
Emsense	Mobility/Transportation	Sweden	
Emulsion Flow Technologies Ltd.	Mobility/Transportation	Japan	
Emvista	Banking/Finance/Insurance/Legal	France	France
Emvista	Banking/Finance/Insurance/Legal	France	France
En 1 Clic	Software Development/Cloud services	France	France
Enchanted Tools	Industry	France	France
Encorp.io	Software Development/Cloud services	Bulgaria	
Enead	Smart City/Building	France	France
ENEDIS	Energy	France	France
Energiency	Software Development/Cloud services	France	France
Energy Robotics	Software Development/Cloud services	Germany	
EnergySage.fr	Energy	France	France
ENERSENS	Mobility/Transportation	France	France
ENERTIME	Energy	France	France
ENFANT DU NORD	Luxury/Fashion/Beauty	France	France
ENGIE	Energy	France	France
ENGIE - REIDS SPORE	Energy	Singapore	
ENGIE Green	Energy	France	France
ENGIE Laborelec	Energy	Belgium	
ENGIE Mon Pilotage Elec	Energy	France	France
ENGIE Mon Pilotage Gaz	Energy	France	France
ENGIE Smart Home - Ma conso +	Energy	France	France
ENGIE Vianeo	Mobility/Transportation	France	France
Enhancy (Miroa )	Consumer goods/Retail/E-commerce	France	France
Enhywhere	Mobility/Transportation	France	France
ENNEA GROUPE	Industry	France	France
Enode	Energy	Norway	
ENOT.ai	Mobility/Transportation	Luxembourg	
Enqura	Banking/Finance/Insurance/Legal	Turkey	
Enrich in Africa Center	Consulting	South Africa	
enso rse	Software Development/Cloud services	France	France
ensogo Inc.	Software Development/Cloud services	Canada	
Enspired	Energy	Austria	
Ensweet	Health	France	France
ENSWEET	Health	France	France
ENTENT	Energy	France	France
Enterprise Armenia	Government/Public institutions	Armenia	
Entrix	Energy	Germany	
Entropy	Mobility/Transportation	France	France
Entroview	Software Development/Cloud services	France	France
Environmental & Human Technologies	Health	United States of America	
Eoliann S.R.L. Societa' Benefit	Banking/Finance/Insurance/Legal	Italy	
EONA-X data space	Mobility/Transportation	France	France
Epago Technologies Limited	Energy	Hong Kong	
ePhantom	Information technologies	France	France
Epic Algeria venture	Government/Public institutions	Algeria	
Epicnpoc	Mobility/Transportation	France	France
EPOCA	Health	France	France
EPSEED	Information technologies	France	France
EQL	Consumer goods/Retail/E-commerce	Australia	
EquaTalent	HR/Training/Education	France	France
Equip	Other	Switzerland	
Eratos	Information technologies	Australia	
ERGOSANTe / HAPO	Industry	France	France
ERMES CYBER SECURITY S.p.A.	Cybersecurity/Defense	Italy	
Esencia Foods	Food	Germany	
ESIEE Paris	HR/Training/Education	France	France
ESPER	Media/Entertainment/Culture	France	France
Esper Bionics	Health	United States of America	
ESTEPS	Health	United States of America	
Estonie - Ambassade d'Estonie	Government/Public institutions	Estonia	
ETALAB	Information technologies	France	France
ETEOS	Software Development/Cloud services	France	France
Eternal Power GmbH	Energy	Germany	
Ether Impact	Consulting	France	France
Ethic First	Consulting	France	France
EthonAI AG	Industry	Switzerland	
ETHYLOWHEEL	Mobility/Transportation	France	France
ETIKL	Banking/Finance/Insurance/Legal	France	France
eTreego Co., Ltd.	Mobility/Transportation	Taiwan	
ETSEME	Information technologies	France	France
ETSOL Engineering	Smart City/Building	France	France
Etudesk	HR/Training/Education	Cote d’Ivoire	
Euglena Co., Ltd.	Industry	Japan	
Euractiv	Media/Entertainment/Culture	Belgium	
Eurailscout France	Mobility/Transportation	France	France
Euronews	Media/Entertainment/Culture	France	France
European Commission - DG Connect	Government/Public institutions	Belgium	
European innovation Council - EIC	Government/Public institutions	Belgium	
European Patent Office	Government/Public institutions	Germany	
Ev.Tech	Energy	Cote d’Ivoire	
evendsa	Media/Entertainment/Culture	Germany	
Everdian	Cybersecurity/Defense	France	France
EVERFLY	Food	France	France
EveryHuman	Luxury/Fashion/Beauty	Netherlands	
Evrotrust		Bulgaria	
EWAKE GERMANY GmbH	Consumer goods/Retail/E-commerce	Germany	
EX9	Mobility/Transportation	France	France
EX9	Mobility/Transportation	France	France
Exaion	Software Development/Cloud services	France	France
Exhalon.io	Health	France	France
Exnaton	Energy	Germany	
Expando	Marketing/Advertising/Communication	Hong Kong	
Experience Abu Dhabi	Hospitality/Tourism/Travel	United Arab Emirates	
Explor.ai	Software Development/Cloud services	Canada	
Explore Media	Media/Entertainment/Culture	France	France
Expo Favela Paris - CUFA	Non Profit	Brazil	
EY	Consulting	United Kingdom	
EYAKO	Cybersecurity/Defense	Reunion	
Eye-Net	Mobility/Transportation	Israel	
Eyesoft	Health	France	France
Ezymob	Mobility/Transportation	France	France
EZYMOB	Mobility/Transportation	France	France
F8th Inc.	Cybersecurity/Defense	Canada	
FabNum des Ministeres Sociaux	Government/Public institutions	France	France
Fabriq	Software Development/Cloud services	France	France
Fabstwines	Food	Luxembourg	
FaceHeart Corporation	Health	Taiwan	
Facil'iti	Marketing/Advertising/Communication	France	France
Factoryz	Software Development/Cloud services	France	France
FAIR VISION	Information technologies	France	France
FAIRLYNE	Software Development/Cloud services	France	France
FAIRME	Food	France	France
FAIRPLAYER	Marketing/Advertising/Communication	France	France
FAME	Consumer goods/Retail/E-commerce	France	France
Famoco	Software Development/Cloud services	France	France
FANarZONE	Media/Entertainment/Culture	France	France
FancyTech	Marketing/Advertising/Communication	China	
Farm to Feed		Kenya	
Farm3	Food	France	France
Farmer Lifeline Technologies	Food	Kenya	
Farpoint Technologies	Consulting	Canada	
FASEYA - YATOUZE	Software Development/Cloud services	France	France
Fast Delivery	Food	Algeria	
Fastecx	Information technologies	Japan	
FastexVerse	Information technologies	Armenia	
FASTPOINT	Industry	France	France
FastSpring	Consumer goods/Retail/E-commerce	United States of America	
FAVA / INTIM'ED	Consumer goods/Retail/E-commerce	France	France
FEELBAT	Smart City/Building	Reunion	
FEELBAT	Smart City/Building	France	France
FEELOBJECT	Smart City/Building	France	France
Female Founder Challenge	Other	France	France
FemTech France	Health	France	France
Fentech	Information technologies	France	France
FIDELATOO	Consumer goods/Retail/E-commerce	France	France
Fifteen	Mobility/Transportation	France	France
Fifth Wall Immersive Media Lab	Media/Entertainment/Culture	United Arab Emirates	
FileOrbis	Software Development/Cloud services	Turkey	
FILIZ	HR/Training/Education	France	France
FILTRALIFE	Industry	France	France
Financial Times	Media/Entertainment/Culture	United Kingdom	
FINAPP SRL	Energy	Italy	
FINDS	Luxury/Fashion/Beauty	France	France
Finense	Banking/Finance/Insurance/Legal	France	France
FININFO SOUTIONS	Banking/Finance/Insurance/Legal	Tunisia	
FINOVOX	Software Development/Cloud services	France	France
Firefly Fusion	Energy	France	France
FireTracking	Government/Public institutions	France	France
FireTracking	Government/Public institutions	France	France
FiveBrane	Health	United States of America	
FKM MOBILITE SAS	Mobility/Transportation	France	France
flameUp	Software Development/Cloud services	France	France
FLAXIB	Mobility/Transportation	Reunion	
Flex System Co., Ltd.	Health	South Korea	
Flex-e	Energy	France	France
FlexLedLight	Marketing/Advertising/Communication	France	France
Flight Buddy	Mobility/Transportation	Germany	
Flipjungle LAB	Information technologies	South Korea	
Fliption Inc	Marketing/Advertising/Communication	United States of America	
Flit Run	Other	France	France
FLOATEE	Health	France	France
FLOATEE	Health	France	France
FLOATING GENES	Health	France	France
Flouci	Banking/Finance/Insurance/Legal		
FLOWARE	Smart City/Building	France	France
Flowie	Banking/Finance/Insurance/Legal	France	France
Fluctuo	Mobility/Transportation	France	France
fluiidd	Industry	France	France
FLYCOPTER PROJECT SAS	Industry	France	France
FLYING WHALES	Mobility/Transportation	France	France
Flywallet	Health	Italy	
FNAC DARTY	Consumer goods/Retail/E-commerce	France	France
FOGO	Industry	France	France
Follow Inspiration	Industry	Portugal	
Follower Products	Cybersecurity/Defense	France	France
Food Analytics	Food	France	France
Food Pilot	Software Development/Cloud services	France	France
FOOD4FUTURE	Consumer goods/Retail/E-commerce	Tunisia	
Foodelles	Health	France	France
FOOTBAR	Information technologies	France	France
Footsider	Personal Services	France	France
Forciot Oy	Mobility/Transportation	Finland	
Forekasts	Software Development/Cloud services	France	France
Fortune Media	Media/Entertainment/Culture	United States of America	
FOSINA	Mobility/Transportation	France	France
FOVIATECH GmbH	Information technologies	Germany	
Foxar	HR/Training/Education	France	France
FR-Alert	Government/Public institutions	France	France
FRACTAL ENERGY	Energy	France	France
France 2030	Government/Public institutions	France	France
France Medias Monde	Media/Entertainment/Culture	France	France
France Quadricycle	Mobility/Transportation	France	France
FRANCE TELEVISIONS	Media/Entertainment/Culture	France	France
FRANCE TRAVAIL	Government/Public institutions	France	France
France VAE	Government/Public institutions	France	France
Franceinfo	Media/Entertainment/Culture	France	France
FREEPLACE	Mobility/Transportation	France	France
French General Secretariat for Investment, France 2030	Government/Public institutions	France	France
French German Tech Lab / Germany	Government/Public institutions	Germany	
French Korean Chamber of Commerce and Industry (FKCCI)	Non Profit	korearepublicof	
French State's Digital Space	Government/Public institutions	France	France
French Tech	Government/Public institutions	France	France
French Tech Grand Paris	Other	France	France
French Tech Guadeloupe	Other	Guadeloupe	
French Tech Guyane		France	France
French Tech Martinique	Non Profit	France	France
French tech Mayotte	Information technologies	Mayotte	
FRENCH TECH REUNION	Other	Reunion	
French Touch Factory	Software Development/Cloud services	France	France
Freshworks	Software Development/Cloud services	United States of America	
FRIMITY	Media/Entertainment/Culture	France	France
Fringuant	Consumer goods/Retail/E-commerce	France	France
FROGANS	Information technologies	France	France
Fruggr	Software Development/Cloud services	France	France
Fruggr	Software Development/Cloud services	France	France
Fujitsu Limited	Information technologies	Japan	
fulfin	Banking/Finance/Insurance/Legal	Germany	
FULLSOON	Food	France	France
Funartech	Information technologies	Canada	
FUNGFEED	Industry	France	France
Fungu'it	Food	France	France
Futura	Media/Entertainment/Culture	France	France
FUTURE FASHION S.R.L.	Consumer goods/Retail/E-commerce	Italy	
Futurewave	Other	Belgium	
Fylia	Media/Entertainment/Culture	France	France
GALENICA.ai	Health	Mozambique	
Gamino	HR/Training/Education	France	France
Gapianne	Health	France	France
Gare ta Becane	Smart City/Building	France	France
GasNas	Energy	Jordan	
GazoTech	Energy	France	France
GCollect	Banking/Finance/Insurance/Legal	France	France
Gcore	Software Development/Cloud services	Luxembourg	
Gedeon	Banking/Finance/Insurance/Legal	France	France
GEEIQ	Marketing/Advertising/Communication	United Kingdom	
Genera	Software Development/Cloud services	Ukraine	
Genexpath	Health	France	France
Genexpath	Health	France	France
GENIAL - Generative IA Lab	Software Development/Cloud services	France	France
GENIAL - Generative IA Lab	Software Development/Cloud services	France	France
Geniess	Energy	Norway	
Gense Technologies	Health	Hong Kong	
Georgie -  LEPL Public Service Hall	Government/Public institutions	Georgia	
German Bionic	Industry	Germany	
German-French Academy for the Industry of the Future	Government/Public institutions	France	France
Giano	Information technologies	Italy	
Gifty Technology	Banking/Finance/Insurance/Legal	Algeria	
Gifty Technology	Banking/Finance/Insurance/Legal	Algeria	
Gino LegalTech	Banking/Finance/Insurance/Legal	France	France
Giotto.ai	Software Development/Cloud services	Switzerland	
GIOZA	Industry	France	France
GISKARD	Software Development/Cloud services	France	France
GK Concept	Luxury/Fashion/Beauty	France	France
GLAASTER	HR/Training/Education	France	France
glafit Inc.	Mobility/Transportation	Japan	
Glanceable	Information technologies	France	France
Glimpact	Software Development/Cloud services	France	France
Global ID SA	Cybersecurity/Defense	Switzerland	
Global Ukraine Banking	Banking/Finance/Insurance/Legal	Ukraine	
GNACOMPANY	Marketing/Advertising/Communication	South Korea	
Gobelins Paris	HR/Training/Education	France	France
GOBIWORLD	Information technologies	France	France
Godspeed IT service Ltd.	Smart City/Building	Taiwan	
GoldenEye Smart Vision	Luxury/Fashion/Beauty	France	France
GoodBarber	Software Development/Cloud services	France	France
GOOGLE	Information technologies	United States of America	
Goparity	Banking/Finance/Insurance/Legal	Portugal	
GottaPhish	Information technologies	France	France
GouvX	Government/Public institutions	France	France
Granular	Energy	France	France
Grapheal	Health	France	France
GRAVIPACK	Industry	France	France
GravitHy	Industry	France	France
Gravvity AI	Marketing/Advertising/Communication	Canada	
Green Eagle	Energy	Spain	
Green Eye Sight	Non Profit	Guadeloupe	
Green Mascareignes Technologies	Industry	Reunion	
Green PRAXIS	Software Development/Cloud services	France	France
Green Tech Innovations	Smart City/Building	France	France
GreenAnt	Information technologies	Netherlands	
GreenBadg	Mobility/Transportation	France	France
greenEd	HR/Training/Education	Cote d’Ivoire	
Greenly	Energy	France	France
Greenly	Software Development/Cloud services	France	France
GREENOCO	Marketing/Advertising/Communication	France	France
Greenpill Tech	HR/Training/Education	Netherlands	
GREENSKIN	Smart City/Building	Reunion	
Greenspector	Information technologies	France	France
GreenWITS	Energy	France	France
GREENZY	Other	Belgium	
GREEZ	Consumer goods/Retail/E-commerce	France	France
Greyn	Industry	France	France
Gridio	Energy	Estonia	
Gr_ksmith	Software Development/Cloud services	Armenia	
Groove Quantum	Other	Netherlands	
GROUPE ADP	Industry	France	France
Groupe Caisse des Depots	Government/Public institutions	France	France
GROUPE INTERACTION • Pôle Innovation [Vigijobs | Prismo | Sinad | Myjob.company | Cookorico | KaviAR Tech] • Elendi (Partenaire Strategique)	HR/Training/Education	France	France
Groupe Les Echos / Le Parisien	Media/Entertainment/Culture	France	France
GROUPE SNCF	Mobility/Transportation	France	France
GuangTai Green Co., Ltd.	Energy	Taiwan	
Gustave Roussy Transfert	Health	France	France
Guyane Developpement Innovation	Non Profit	France	France
GWENLAKE	Information technologies	France	France
GxpManager	Software Development/Cloud services	France	France
GYEONGGI-DO DX Zone	Government/Public institutions	South Korea	
Gymlib	Health	France	France
Gynger	Health	France	France
H24Care	Health	France	France
H2Gremm	Energy	France	France
Haiper	Media/Entertainment/Culture	United Kingdom	
Handiroad	Mobility/Transportation	France	France
HANDIROAD	Mobility/Transportation	France	France
Handsome	Banking/Finance/Insurance/Legal	France	France
HANDSOME	Banking/Finance/Insurance/Legal	France	France
Hao Juen Technology	Other	Taiwan	
Haomah Sports	Consumer goods/Retail/E-commerce	France	France
happly.AI	Banking/Finance/Insurance/Legal	Canada	
HAPPLYZ Medical	Health	France	France
HappyPal	Information technologies	France	France
Happyvore	Food	France	France
Hattaa!	Consumer goods/Retail/E-commerce	Algeria	
HautAI	Software Development/Cloud services	Estonia	
HawAI.tech	Information technologies	France	France
HeatVentors	Energy	Hungary	
HEC Paris	HR/Training/Education	France	France
Heelio	Banking/Finance/Insurance/Legal	France	France
Heex Technologies	Software Development/Cloud services	France	France
HelioRec	Energy	France	France
HELLO ART UP	Health	France	France
Helpy	Software Development/Cloud services	France	France
HEPHAISTOS-Pharma	Health	France	France
HephIA	Information technologies	France	France
HERALBONY Co., Ltd.	Marketing/Advertising/Communication	Japan	
HERAPREG	Health	France	France
HERITAGE	Media/Entertainment/Culture	France	France
HEURISTECH		France	France
Hexacup	Non Profit	France	France
HexaDone	Smart City/Building	France	France
HEXAGRO URBAN FARMING SRL	Consumer goods/Retail/E-commerce	Italy	
Hexamind	Information technologies	France	France
HICOOL	Consulting	China	
Hiflow	Mobility/Transportation	France	France
Highcast	Industry	France	France
HIGO TECHS	Health	France	France
Hippoc	Marketing/Advertising/Communication	Canada	
Hippolyte.ai	HR/Training/Education	France	France
Hitachi, Ltd.	Industry	Japan	
Hive Electric	Energy	France	France
HKVOR	Industry	France	France
Holcim Maqer Ventures	Smart City/Building	Switzerland	
Holis	Consumer goods/Retail/E-commerce	France	France
Holis	Consumer goods/Retail/E-commerce	France	France
Holis	Consumer goods/Retail/E-commerce	France	France
Holistic AI	Software Development/Cloud services	United Kingdom	
HOLUSION	Marketing/Advertising/Communication	France	France
Hong Kong Trade Development Council	Government/Public institutions	Hong Kong	
HONOR	Consumer goods/Retail/E-commerce	China	
Hoopcarpool	Mobility/Transportation	Spain	
Hoory AI	Information technologies	Armenia	
Hopae Inc.	Cybersecurity/Defense	South Korea	
Hope Valley AI	Health	France	France
HOPE VALLEY AI	Health	France	France
HOPINNOV SAS	Health	France	France
HOPPEN	Health	France	France
Horizon	Consumer goods/Retail/E-commerce	Germany	
Houses of Emerging Technologies	Government/Public institutions	Italy	
HOWCOW	Other	Ukraine	
HQI	Other	France	France
HRFlow.ai	HR/Training/Education	France	France
Hsabati	Information technologies	Morocco	
HSL Technologies	Energy	France	France
https://www.back2buzz.eu	Telecom/Connectivity	Belgium	
HUAWEI	Information technologies	China	
Hub France Gaia X	Software Development/Cloud services	France	France
HUB Institute	Consulting	France	France
hub.brussels	Government/Public institutions	Belgium	
Hubert	HR/Training/Education	Sweden	
Hubfinance	Banking/Finance/Insurance/Legal	Luxembourg	
HubUR Europ - Boon H2 hydrogen Bike	Consumer goods/Retail/E-commerce	Ireland	
Hugging Face	Information technologies	United States of America	
Humanitics.ai	Luxury/Fashion/Beauty	France	France
Humanlinker	Software Development/Cloud services	France	France
Humapro	HR/Training/Education	France	France
hushh.ai	Software Development/Cloud services	United States of America	
Hxperience	Smart City/Building	France	France
Hyde	Software Development/Cloud services	Germany	
HygieSys	Health	Tunisia	
HYLeRIA	Luxury/Fashion/Beauty	France	France
Hyperplan	Food	France	France
Hypershell Co., Ltd.	Mobility/Transportation	China	
Hypocaps	Health	France	France
HYPORT	Energy	France	France
Hysper Tech	Energy	Zambia	
Hyundai Motor and Kia (ZER01NE)	Mobility/Transportation	South Korea	
I want to exhibit at VivaTech	Other	France	France
I-PERCUT	Health	France	France
I'MTech	Media/Entertainment/Culture	France	France
i2Cool	Energy	Hong Kong	
IA MEDICAL	Health	France	France
IARA	Smart City/Building	France	France
iAVC	Health	France	France
IBC CORP - SCALING PARROTS	Software Development/Cloud services	Italy	
ible Technology Inc.	Health	Taiwan	
IBM	Information technologies	United States of America	
Icosium	Media/Entertainment/Culture	France	France
Ida	Software Development/Cloud services	France	France
iDAKTO	Information technologies	France	France
IDAWO	Health	France	France
IDDOM Aquaponis	Food	Guadeloupe	
Idem Creative Arts School	HR/Training/Education	France	France
IDICT - ADDEVICE	Information technologies	Armenia	
iFLYTEK Co., Ltd.	Information technologies	China	
IFP Energies nouvelles	Energy	France	France
IGN	Government/Public institutions	France	France
IGONOGO	Software Development/Cloud services	France	France
IGONOGO	Software Development/Cloud services	France	France
ILeCO®	Marketing/Advertising/Communication	Overseas France	
ILEY'COM	Consumer goods/Retail/E-commerce	France	France
ILYA	Consumer goods/Retail/E-commerce	France	France
imki	Luxury/Fashion/Beauty	France	France
immersive.paris	Media/Entertainment/Culture	France	France
Impact Bridge	Other	France	France
IMPACT+	Marketing/Advertising/Communication	France	France
Impulsio.	Information technologies	France	France
IMT	HR/Training/Education	France	France
In Foreign We Speak (IFWS)	HR/Training/Education	France	France
In Heart	Health	France	France
Inbolt	Industry	France	France
INBOUND INTELLIGENCE SOLUTION	Information technologies	France	France
INCARI-Labs	Software Development/Cloud services	France	France
Inclusivity Solutions	Banking/Finance/Insurance/Legal	South Africa	
INCOMEDIA Srl	Consumer goods/Retail/E-commerce	Italy	
INDIENOV	Health	France	France
Inekto	Software Development/Cloud services	France	France
INEL INNOV	Industry	France	France
INEO	Information technologies	Italy	
Inetum	Consulting	France	France
Infix Technologies	Cybersecurity/Defense	Netherlands	
info.gouv.fr	Government/Public institutions	France	France
INFORICH INC.	Information technologies	Japan	
Infraspeak	Software Development/Cloud services	Portugal	
INGEN MECANICA	Energy	Algeria	
INGRAM MICRO	Software Development/Cloud services	France	France
inHEART	Health	France	France
Initiative France	Non Profit	France	France
Innofenso	Other	France	France
INNOPHYS CO., LTD	Industry	Japan	
Innov Invest	Consumer goods/Retail/E-commerce	Cote d’Ivoire	
INNOV TECH	Marketing/Advertising/Communication	Bangladesh	
Innoving	Banking/Finance/Insurance/Legal	Cote d’Ivoire	
INOOCQ	Industry	France	France
inoRain LLC	Software Development/Cloud services	Armenia	
INOVI Group	Consumer goods/Retail/E-commerce	Algeria	
INP-HB	Government/Public institutions	Cote d’Ivoire	
INPI	Government/Public institutions	France	France
INRIA	Government/Public institutions	France	France
INRIA	Government/Public institutions	France	France
INSTADRIVE	Mobility/Transportation	Tunisia	
Institut Mines-Telecom (IMT)	Government/Public institutions	France	France
Institut Polytechnique de Paris (IP Paris)	Government/Public institutions	France	France
InStudent Group	HR/Training/Education	Australia	
Intaj Mouhtawayat	Software Development/Cloud services	Algeria	
Integral Geometry Science Ltd.	Energy	Japan	
Integrator	Personal Services	Bulgaria	
Intelligent Machines Limited	Information technologies	Bangladesh	
International Finance Corporation	Banking/Finance/Insurance/Legal	United States of America	
Interprefy	Software Development/Cloud services	Switzerland	
Interstis	Software Development/Cloud services	France	France
IntiReality	Marketing/Advertising/Communication	France	France
Intuos	Information technologies	Italy	
Inuk	Software Development/Cloud services	France	France
Inument Solutions Limited	Software Development/Cloud services	Bangladesh	
Invest In Madrid	Government/Public institutions	Spain	
Invest in Türkiye	Government/Public institutions	Turkey	
Investiv	Consulting	Cote d’Ivoire	
InVirtus Technologies	Information technologies	France	France
InvoiceQ	Software Development/Cloud services	Jordan	
inwink - Event & Community Platform	Marketing/Advertising/Communication	France	France
IOASIS	HR/Training/Education	France	France
ION-X	Industry	France	France
IONNYK	Media/Entertainment/Culture	Belgium	
IOX GmbH	Information technologies	Germany	
iPerf	Health	France	France
IPIN LABS	Information technologies	South Korea	
IPPON	Consulting	France	France
IPSUM TEK	Smart City/Building	France	France
IQM Quantum Computers	Information technologies	France	France
Ircam amplify	Marketing/Advertising/Communication	France	France
iReel	Information technologies	Australia	
IRIS	Banking/Finance/Insurance/Legal	France	France
IrWise	Smart City/Building	Tunisia	
IS Predict GmbH	Cybersecurity/Defense	Germany	
IsCoolLab Co., Ltd.	Software Development/Cloud services	Taiwan	
iStaging Corp & iStaging Asia	Software Development/Cloud services	Taiwan	
iStaging Corp.	Software Development/Cloud services	Taiwan	
Istya	Smart City/Building	France	France
Istya	Smart City/Building	France	France
ISTYA	Smart City/Building	France	France
ISTYA	Smart City/Building	France	France
it.com Domains	Information technologies	United Kingdom	
ITA - Italian Trade Agency	Government/Public institutions	Italy	
ITECH RESTORE	Telecom/Connectivity	France	France
ITER Organization	Energy	France	France
itinair'bis	Hospitality/Tourism/Travel	France	France
ITO ITO	Software Development/Cloud services	French Polynesia	
IUBENDA SRL	Software Development/Cloud services	Italy	
iUMTEK	Industry	France	France
IVADO Labs	Software Development/Cloud services	Canada	
iYako!	Software Development/Cloud services	Cote d’Ivoire	
Izaac	Smart City/Building	France	France
IZYPAPER	Banking/Finance/Insurance/Legal	France	France
Jabu	Food	France	France
JAEPA X	Information technologies	South Korea	
JAFER	Government/Public institutions	France	France
Jalios	Software Development/Cloud services	France	France
Jami Life	Health	France	France
Jangolo	Consumer goods/Retail/E-commerce	Cameroon	
Japan Pavilion (JETRO)	Government/Public institutions	Japan	
JAPET MEDICAL	Health	France	France
"JAPON GLOBAL ""Toray Industries, Inc."""	Mobility/Transportation	Japan	
JCDecaux	Media/Entertainment/Culture	France	France
JCHI Global	Smart City/Building	South Korea	
JE-IMT	Consulting	France	France
Jean-Luc DUFOUR	Industry	France	France
Jedid	Luxury/Fashion/Beauty	France	France
Jedlix	Mobility/Transportation	Netherlands	
Jeune Afrique	Media/Entertainment/Culture	France	France
Jiaxing DYNGA semiconductor co.,Ltd	Health	China	
Jiccee	Software Development/Cloud services	France	France
Jikantechno Inc.	Industry	Japan	
Jmem Technology Co., Ltd.	Cybersecurity/Defense	Taiwan	
JOBBIZ	HR/Training/Education	France	France
JOBECAM	HR/Training/Education	Brazil	
Jobfirst	HR/Training/Education	Luxembourg	
Jokalante	Information technologies	Senegal	
JOOKS	Software Development/Cloud services	France	France
Jua.ai	Energy	Switzerland	
JUISCI	Health	France	France
Jumbo Mana	Information technologies	France	France
Jungle AI	Energy	Netherlands	
Juri'Predis	Software Development/Cloud services	France	France
JustHealth	Health	Germany	
K-STARTUP (Korea Startups)	Consulting	South Korea	
Kabin	Smart City/Building	France	France
KACO	Mobility/Transportation	Tunisia	
KAI - KnowledgeAI	Software Development/Cloud services	France	France
KAI - KnowledgeAI	Software Development/Cloud services	France	France
KAIST	Government/Public institutions	South Korea	
Kamae	HR/Training/Education	France	France
kapptivate	Information technologies	France	France
Kardinal	Software Development/Cloud services	France	France
karli solutions	HR/Training/Education	France	France
Karlsruhe Institute of Technology (KIT)	Government/Public institutions	Germany	
Katalyze AI	Health	Canada	
Kauz.ai	Information technologies	Germany	
Kavaken	Energy	United Kingdom	
KeepIoT - Consulting IoT	Information technologies	Belgium	
Keewe	Banking/Finance/Insurance/Legal	France	France
KEIWA	Consulting	Cote d’Ivoire	
KeNeYA KOURA	Health	Mali	
KEOPASS	Cybersecurity/Defense	France	France
KEREYA	Health	Senegal	
KERU	Hospitality/Tourism/Travel	France	France
KESK	Energy	Iraq	
Keyban	Information technologies	France	France
KIGNON	Food	France	France
KIGNON	Food	France	France
Kiido	HR/Training/Education	France	France
Kikleo	Food	France	France
Kineis	Telecom/Connectivity	France	France
Kinomap SAS	Media/Entertainment/Culture	France	France
KIOSK	Software Development/Cloud services	France	France
Kiostore	Software Development/Cloud services	Algeria	
Kipsum	Energy	France	France
Kipsum	Energy	France	France
Kirae	HR/Training/Education	France	France
Kivisense	Consumer goods/Retail/E-commerce	China	
KLAXOON	Software Development/Cloud services	France	France
Kleecks	Software Development/Cloud services	Italy	
KLEMO - Les Defricheuses	Media/Entertainment/Culture	France	France
KLS Desk	Banking/Finance/Insurance/Legal	France	France
KMOOVE	Software Development/Cloud services	France	France
KMOOVE	Software Development/Cloud services	France	France
Kobi	HR/Training/Education	France	France
Kogeet	Software Development/Cloud services	France	France
Kokoro GmbH	HR/Training/Education	Germany	
Kolecto	Banking/Finance/Insurance/Legal	France	France
Kolpolok	Cybersecurity/Defense	Bangladesh	
Kolverr	HR/Training/Education	France	France
Korea Electronics Show(KES)	Government/Public institutions	South Korea	
Korea Institute of Design Promotion(KIDP)	Luxury/Fashion/Beauty	South Korea	
KOREA Pavilion	Government/Public institutions	South Korea	
KPMG	Consulting	France	France
KUCIBOK	Consumer goods/Retail/E-commerce	Senegal	
Kumulus Water	Energy	France	France
Kumulus Water	Energy	France	France
Kumulus Water	Energy	France	France
Kunto	Health	France	France
KYLII KIDS	Media/Entertainment/Culture	France	France
Kyoto Fusioneering Ltd.	Energy	Japan	
L'Escalator	Other	France	France
L'IA du Canada | Canada's AI	Government/Public institutions	Canada	
L'OREAL GROUPE	Luxury/Fashion/Beauty	France	France
La Fabrique des Geocommuns	Government/Public institutions	France	France
La Fresque du Climat	Non Profit	France	France
La Fresque du Numerique	HR/Training/Education	France	France
LA POSTE GROUPE	Other	France	France
La Ruche Health	Health	Cote d’Ivoire	
La tribu des supers	Health	France	France
la Vitre	Software Development/Cloud services	France	France
LabLabee	HR/Training/Education	United States of America	
LABORATOIRE BIO STRATEGE	Industry	French Guiana	
laCollection.io	Hospitality/Tourism/Travel	France	France
Lactips	Industry	France	France
LafricaMobile	Telecom/Connectivity	Senegal	
LAMPI AI	Software Development/Cloud services	France	France
LAND OF AFRICA SAS	Food	Senegal	
Langcode	Software Development/Cloud services	South Korea	
Lapala	Software Development/Cloud services	France	France
LatenceTech	Telecom/Connectivity	Canada	
LatenceTech	Telecom/Connectivity	Canada	
Latitude	Cybersecurity/Defense	France	France
LayerOps	Software Development/Cloud services	France	France
Le Lab RH	HR/Training/Education	France	France
Le reseau Datalliance de l'IGN	Government/Public institutions	France	France
Le Reseau des Carnot	Government/Public institutions	France	France
LE TeNeBRION FRANÇAIS	Food	France	France
LeA-CFI	HR/Training/Education	France	France
LEADBAY	Consumer goods/Retail/E-commerce	France	France
Leadzai	Marketing/Advertising/Communication	Portugal	
Leasi	Consumer goods/Retail/E-commerce	France	France
LEASYPEASY	Smart City/Building	France	France
Lecko	HR/Training/Education	France	France
Ledger	Other	France	France
LEDSCAPE	Media/Entertainment/Culture	France	France
Leexi	Software Development/Cloud services	Belgium	
LegalOn Technologies, Inc.	Information technologies	Japan	
LEGIFORM	Banking/Finance/Insurance/Legal	France	France
Legitbee	Banking/Finance/Insurance/Legal	France	France
LeHibou	Information technologies	France	France
LEILA - industrial intelligence	Industry	French Guiana	
Lemay.ai	Consulting	Canada	
LEMO	Telecom/Connectivity	Switzerland	
Lengo AI	Software Development/Cloud services	Senegal	
LES BeNeFIQUES	Consumer goods/Retail/E-commerce	France	France
Les Conseillers du Commerce Exterieur (CCE)	Non Profit	France	France
Les Determines	Non Profit	France	France
Les Martines	Media/Entertainment/Culture	France	France
Les Numeriques	Media/Entertainment/Culture	France	France
Les Ripeurs	Smart City/Building	France	France
LetsNurture	Information technologies	Canada	
Letswork	Hospitality/Tourism/Travel	United Arab Emirates	
Leviathan Dynamics		France	France
Levita Magic	Consumer goods/Retail/E-commerce	Belgium	
LEXISTEMS	Information technologies	France	France
LexRock AI	Software Development/Cloud services	Canada	
Leya labs	Banking/Finance/Insurance/Legal	Cote d’Ivoire	
LEYA Labs	Banking/Finance/Insurance/Legal	France	France
Lib & Lou	Consumer goods/Retail/E-commerce	France	France
Liberfit	Software Development/Cloud services	France	France
LiberteWatts	Energy	France	France
Libertify	Banking/Finance/Insurance/Legal	Hong Kong	
Libpet Tech Limited	Mobility/Transportation	Hong Kong	
Lierda (___)	Information technologies	China	
LifeFoundry______	Industry	China	
LIFERAY	Software Development/Cloud services	United States of America	
Lifiled	Energy	Cote d’Ivoire	
LightOn	Software Development/Cloud services	France	France
LightOn	Software Development/Cloud services	France	France
LightOn	Software Development/Cloud services	France	France
LIGHTON	Software Development/Cloud services	France	France
Lightyear	Mobility/Transportation	Netherlands	
LILAEA	Other	France	France
Lille Metropole & Pôle Metropolitain de l'Artois	Government/Public institutions	France	France
Lingban Technology______	Industry	China	
Linkedin	Information technologies	United States of America	
Linksoul Holdings Company Limited	Smart City/Building	Hong Kong	
LionsTech Senegal	Government/Public institutions	Senegal	
LIPITT	Information technologies	France	France
LiveForward co., Ltd	Consumer goods/Retail/E-commerce	South Korea	
LiveLink	Marketing/Advertising/Communication	United Kingdom	
LivingPackets	Mobility/Transportation	France	France
LIVMED'S	Health	France	France
Lobster	Banking/Finance/Insurance/Legal	France	France
Local Decarbonization Solutions	Energy	France	France
LOCALTEAMS	Smart City/Building	France	France
Lockem	Cybersecurity/Defense	Portugal	
Logitech G	Information technologies	Switzerland	
Logomix, Inc.	Industry	Japan	
London & Partners	Banking/Finance/Insurance/Legal	United Kingdom	
LOOKAROUN	Hospitality/Tourism/Travel	France	France
Lootorium	Luxury/Fashion/Beauty	France	France
Looztick	Personal Services	France	France
LORIN	Energy	Belgium	
Lormauto	Mobility/Transportation	France	France
Losanje		France	France
Loxamed healthcare solutions expert	Health	France	France
LS GROUP	Software Development/Cloud services	France	France
Luchrome	Industry	France	France
Lumin	Information technologies	New Zealand	
LUMISSOLY SAS	Luxury/Fashion/Beauty	France	France
LUNAAR	Information technologies	France	France
Luniwave	Hospitality/Tourism/Travel	France	France
LUNU	Information technologies	Germany	
LUPISE	Cybersecurity/Defense	France	France
Luxolis AI	Information technologies	South Korea	
LVMH	Other	France	France
Lynx Mixed Reality	Industry	France	France
m-work	Other	France	France
Ma Procuration		France	France
ma-cantine	Food	France	France
MAD	Other	Germany	
Madalia.World	Other	Portugal	
Maddyness	Media/Entertainment/Culture	France	France
Maekyung Media Group	Media/Entertainment/Culture	South Korea	
Maeving	Mobility/Transportation	United Kingdom	
MAGENTINE HEALTHCARE	Health	France	France
MAGIC LEMP	Information technologies	France	France
MAGIC LEMP (IDF)	Information technologies	France	France
Magic LEMP (PARIS SACLAY)	Government/Public institutions	France	France
MAGMA	Food	France	France
Magment GmbH	Mobility/Transportation	Germany	
Mago	Software Development/Cloud services	United Kingdom	
Magoe Technologie	Information technologies	Guinea	
Maintners	Software Development/Cloud services	France	France
MAISON M	Luxury/Fashion/Beauty	France	France
Maka Health	Health	Canada	
MAKAIN	Consulting	Saudi Arabia	
Makersite	Industry	Germany	
Makila AI	Information technologies	Canada	
Malakoff Humanis	Banking/Finance/Insurance/Legal	France	France
Malt	Other	France	France
Malt		France	France
Management Tools Company	Software Development/Cloud services	Belgium	
Mandarine Academy	HR/Training/Education	France	France
MANDARINE ROBOTIQUE	Industry	France	France
ManoMotion	Information technologies	Sweden	
MANPOWERGROUP	HR/Training/Education	United States of America	
Mansio GmbH	Mobility/Transportation	Germany	
Mantis-AI	Media/Entertainment/Culture	Brazil	
Manystacks	Information technologies	France	France
Mappedin Inc.	Information technologies	Canada	
Marinachain	Industry	South Korea	
Mark	Health	Ukraine	
MarketLeap	Consumer goods/Retail/E-commerce	Luxembourg	
MARSES Robotics	Other	United Arab Emirates	
MARTINIQUE DEVELOPPEMENT	Government/Public institutions	Martinique	
Marvin Recruiter	Software Development/Cloud services	France	France
Matawan	Mobility/Transportation	France	France
mateligent GmbH	Other	Germany	
Matomo	Information technologies	New Zealand	
MATVISIO Omnes	Software Development/Cloud services	France	France
Maxxing	Software Development/Cloud services	France	France
May	HR/Training/Education	France	France
MAYBIOTECH	Health	France	France
Mazars	Banking/Finance/Insurance/Legal	France	France
MCE	Food	korearepublicof	
McSAF Inside Oncology	Health	France	France
me energy	Energy	Germany	
ME, MOBILE ECOSYSTEMS CEDEAO	Telecom/Connectivity	Senegal	
MECAWARE	Energy	France	France
MEDADOM	Health	France	France
MEDIAIPLUS, Inc.	Information technologies	South Korea	
MediaLink	Consulting	United States of America	
MEDICUD SRL	Health	Italy	
MEDITERRANEO LAB 4.0 SRL	Information technologies	Italy	
MEDVIR	Health	France	France
MedySapiens, Inc.	Health	South Korea	
Meerana Information Technology	Information technologies	United Arab Emirates	
Meersens	Health	France	France
MEG Science	Consulting	Italy	
meleap inc.	Media/Entertainment/Culture	Japan	
Memorality	Software Development/Cloud services	United States of America	
MENDO	Software Development/Cloud services	France	France
Mentalista	Health	France	France
MERELY	Food	France	France
MESSIBAT INTERNATIONAL France	Smart City/Building	France	France
META	Information technologies	United States of America	
METAWORLDX	Smart City/Building	Canada	
METI.ai	Mobility/Transportation	Canada	
METIERS 360	HR/Training/Education	France	France
Metiers360	HR/Training/Education	France	France
Metric	Information technologies	Armenia	
Metropole du Grand Paris	Government/Public institutions	France	France
MEWS LABS	Information technologies	France	France
MezzoLab Animation	Marketing/Advertising/Communication	Portugal	
MICCO	Banking/Finance/Insurance/Legal	France	France
Microsoft	Software Development/Cloud services	United States of America	
MIDGARD	Software Development/Cloud services	France	France
Midljob	Software Development/Cloud services	France	France
Miles Republic	Media/Entertainment/Culture	France	France
miLibris	Media/Entertainment/Culture	France	France
Milvue	Health	France	France
MIMOPT Technology	Telecom/Connectivity	France	France
MINCATEC ENERGY	Energy	France	France
Mini Green Power	Energy	France	France
Ministere de l'Agriculture et de l'Alimentation	Government/Public institutions	France	France
Ministere de l'Economie, des Finances et de la Souverainete Industrielle et Numerique	Government/Public institutions	France	France
Ministere de la Justice	Government/Public institutions	France	France
Ministere de la Transition Ecologique et de la Cohesion des territoires	Government/Public institutions	France	France
Ministere des Armees	Government/Public institutions	France	France
Minkey	HR/Training/Education	France	France
MIOM - Permis de conduire	Government/Public institutions	France	France
MiPih	Health	France	France
Mirror	Marketing/Advertising/Communication	Italy	
Mistertemp' Group	HR/Training/Education	France	France
MISTRAL AI	Software Development/Cloud services	France	France
MISTRAL Penal	Government/Public institutions	France	France
Mistu Limited	Consumer goods/Retail/E-commerce	Ireland	
Mitigant	Cybersecurity/Defense	Germany	
Mitsubishi Heavy Industries, Ltd.	Energy	Japan	
Mitsubishi UFJ Financial Group, Inc.(MUFG)	Banking/Finance/Insurance/Legal	Japan	
MLR s.r.l.	Media/Entertainment/Culture	Italy	
MOABI Solutions	Cybersecurity/Defense	France	France
Mob-Energy	Energy	France	France
MOBICRAWL	Cybersecurity/Defense	France	France
Mobilic	Mobility/Transportation	France	France
Mobility & Smart City Park by Togg	Mobility/Transportation	France	France
Mobility Metrix	Information technologies	France	France
MOBINN	Mobility/Transportation	South Korea	
MOBIUSPACK	Consumer goods/Retail/E-commerce	France	France
Moda Live	Luxury/Fashion/Beauty	France	France
Modus Create	Consulting	United States of America	
Mogic AI	Information technologies	China	
MOiZ	Industry	France	France
molluSCAN-eye	Smart City/Building	France	France
Moment Factory	Media/Entertainment/Culture	Canada	
Moments Lab	Information technologies	France	France
MON ARTISAN SAS	Smart City/Building	Cote d’Ivoire	
MONA AI GmbH	Software Development/Cloud services	Germany	
monday.com	Information technologies	Israel	
MONELECTROBOX	HR/Training/Education	France	France
Mooncard	Banking/Finance/Insurance/Legal	France	France
Moov AI	Information technologies	Canada	
Morpheus.Network	Software Development/Cloud services	Canada	
Moten Technologies	Health	France	France
MotionXP	HR/Training/Education	France	France
MotorBioNet	Mobility/Transportation	France	France
MS	Smart City/Building	France	France
MS4ALL	Software Development/Cloud services	France	France
MUBE	Telecom/Connectivity	France	France
mui Lab, Inc.	Smart City/Building	Japan	
Multiverse Computing SAS	Information technologies	France	France
Munemjo Entertainment	Media/Entertainment/Culture	France	France
Muodim	Industry	France	France
Murena	Cybersecurity/Defense	France	France
MUSAAD AI - _____	Marketing/Advertising/Communication	Jordan	
My Fenix	Banking/Finance/Insurance/Legal	France	France
MY HEALTHY	Health	France	France
My Job Glasses	HR/Training/Education	France	France
My Love Lock	Hospitality/Tourism/Travel	Spain	
My S Life	Health	France	France
My watchman	Software Development/Cloud services	Liberia	
My-Money SRL	Banking/Finance/Insurance/Legal	Italy	
MYAGO 3D	Industry	France	France
MyAssetRocks	Software Development/Cloud services	France	France
MYASSETROCKS	Software Development/Cloud services	Reunion	
MYBUBBLEHEALTH	Health	France	France
MycoLutions	Smart City/Building	Germany	
MYCOSMETIK	Luxury/Fashion/Beauty	France	France
MYDITEK	Information technologies	Overseas France	
MyDPO Solutions	Software Development/Cloud services	France	France
MyFit Solutions	Software Development/Cloud services	France	France
MyJoint	Health	Switzerland	
MYLIME SRL	Information technologies	Italy	
MyOpinion	Information technologies	Cote d’Ivoire	
mySmartMove	Health	France	France
MYTHINGS	Other	South Korea	
MyTroc	Consumer goods/Retail/E-commerce	France	France
MyWaves Technologies Ltd	Health	United Kingdom	
MZ TECHNOLOGIE	Other	France	France
N1 Circular GmbH	Software Development/Cloud services	Germany	
N2AIR	Energy	France	France
NAAREA	Energy	France	France
nabatic	Software Development/Cloud services	Algeria	
NADK.IO	Media/Entertainment/Culture	France	France
Naio Technologies	Industry	France	France
Nalios	Information technologies	Belgium	
Nami Beauty	Luxury/Fashion/Beauty	France	France
namlatic	Hospitality/Tourism/Travel	Algeria	
NamX	Mobility/Transportation	France	France
Nanomade Lab	Other	France	France
NANOME inc	Information technologies	United States of America	
Nanoz	Other	France	France
Narnia Labs. Co., Ltd.	Software Development/Cloud services	korearepublicof	
natif.	HR/Training/Education	France	France
Naturamole	Industry	France	France
Navee	Information technologies	France	France
NcodiN	Information technologies	France	France
NCREE	Smart City/Building	Taiwan	
NEL'ANIM	Media/Entertainment/Culture	Senegal	
Nelson	Mobility/Transportation	France	France
NEMO	Energy	France	France
Neo-Justice	Banking/Finance/Insurance/Legal	France	France
NEOBRAIN	Software Development/Cloud services	France	France
NeoEarth	Food	France	France
NEOLISTO	Health	France	France
Neology Hydrogen SA	Energy	Switzerland	
NEOMIND GmbH	Mobility/Transportation	Germany	
NEOVYA Mobility by Technology	Software Development/Cloud services	France	France
NEOVYA Mobility by Technology	Mobility/Transportation	France	France
NeoXperiences	Media/Entertainment/Culture	France	France
Neptech	Mobility/Transportation	France	France
NepTech	Mobility/Transportation	France	France
NESTECH CORPORATION Ltd.	Cybersecurity/Defense	Taiwan	
Nestor	Cybersecurity/Defense	France	France
Netcarbon	Smart City/Building	France	France
Netcarbon	Smart City/Building	France	France
Netherlands	Other	Netherlands	
NETWORK MONITORING USING DRONE	Energy	France	France
Neurabody (Health AI)	Health	Luxembourg	
Nevomo	Mobility/Transportation	Poland	
New Caledonian Tech & Pacific Startups	Government/Public institutions	New Caledonia	
New Core Technology Ltd.	Software Development/Cloud services	China	
New Zealand - New Zealand Trade & Enterprise	Government/Public institutions	New Zealand	
NEWAY	Mobility/Transportation	France	France
Newired	Software Development/Cloud services	Italy	
Newrizon Co., Ltd.	Smart City/Building	South Korea	
NEXALINX	Software Development/Cloud services	Bangladesh	
NexRetail Co., Ltd.	Marketing/Advertising/Communication	United States of America	
NEXT BASE Corp.	Consulting	Japan	
Next Gate Tech	Software Development/Cloud services	Luxembourg	
Next one	Mobility/Transportation	Cote d’Ivoire	
Nextflag Srl	Hospitality/Tourism/Travel	Italy	
NextMRI	Health	Spain	
nextract energy	Energy	Germany	
NEXTSENSE S.R.L/BIOVITAE	Health	Italy	
NEYRET	Industry	France	France
Nicebuild LLC	Consumer goods/Retail/E-commerce	United States of America	
Nicebuild LLC	Consumer goods/Retail/E-commerce	United States of America	
NIDLP	Industry	Saudi Arabia	
Nijta	Cybersecurity/Defense	France	France
NIJTA	Cybersecurity/Defense	France	France
NIJTA	Cybersecurity/Defense	France	France
Nikkei Inc.	Media/Entertainment/Culture	Japan	
NINEWATT	Energy	korearepublicof	
Nintex	Software Development/Cloud services	United States of America	
NINU ltd.	Luxury/Fashion/Beauty	Slovenia	
Niramai Health Analytix	Health	India	
Nissin Denki Kohsaku Co., Ltd	Software Development/Cloud services	Japan	
Nivotech	Smart City/Building	France	France
NOLEJ	HR/Training/Education	France	France
NOMAD EDUCATION	HR/Training/Education	France	France
NOOTA	Software Development/Cloud services	France	France
Norbert Health	Health	United States of America	
Notex	Mobility/Transportation	France	France
Notify	Marketing/Advertising/Communication	France	France
NOULA	Mobility/Transportation	France	France
Novable	Information technologies	Belgium	
Novocycle Technologies	Industry	United States of America	
Novus Technologies Inc	Software Development/Cloud services	Turkey	
NST / SMO Solar Process	Energy	France	France
NTWU	Media/Entertainment/Culture	France	France
NUBO	Banking/Finance/Insurance/Legal	France	France
NuLink	Media/Entertainment/Culture	Switzerland	
NUMALIS	Software Development/Cloud services	France	France
NUMALIS	Software Development/Cloud services	France	France
NuMind	Software Development/Cloud services	France	France
Nuvolos	Software Development/Cloud services	Switzerland	
NVIDIA	Information technologies	United States of America	
NXN Labs	Software Development/Cloud services	South Korea	
O'PRUEBA Technology Inc.	Software Development/Cloud services	Taiwan	
Obo World	HR/Training/Education	France	France
obodo	Software Development/Cloud services	United Kingdom	
Obsess	Software Development/Cloud services	United States of America	
ObyO (by aSmartWorld)	Software Development/Cloud services	Belgium	
Ochy	Other	France	France
OCTAVIO	Industry	France	France
Octolo	Banking/Finance/Insurance/Legal	France	France
Octolo	Banking/Finance/Insurance/Legal	France	France
OCTOPIZE	Software Development/Cloud services	France	France
Odaptos	Software Development/Cloud services	France	France
Odaptos	Software Development/Cloud services	France	France
Odin Outsourcing	Banking/Finance/Insurance/Legal	Bangladesh	
Off-Works	Marketing/Advertising/Communication	France	France
Oghji	Energy	France	France
OID	Non Profit	France	France
Okta	Software Development/Cloud services	United States of America	
OLECIO	HR/Training/Education	France	France
Olenergies	Energy	France	France
Olenergies	Energy	France	France
Olumee SAS	Smart City/Building	France	France
Olvid	Cybersecurity/Defense	France	France
OMBREA	Energy	France	France
OMENA	Health	France	France
OMIND	HR/Training/Education	France	France
OMNI	Mobility/Transportation	France	France
On -X	Information technologies	France	France
ON&UP Partners	Consulting	korearepublicof	
Oncoustics AI	Health	Canada	
One Act, Inc.	Software Development/Cloud services	Japan	
OneLayer	Cybersecurity/Defense	United States of America	
OnePlan	Smart City/Building	United Kingdom	
Onesoftdigm	Health	South Korea	
OneVisage	Cybersecurity/Defense	Switzerland	
OneVisage	Cybersecurity/Defense	France	France
Onima	Food	France	France
ONLYOFFICE	Information technologies	Latvia	
Onout Inc.	Luxury/Fashion/Beauty	South Korea	
ONPARLEDETOUT	Media/Entertainment/Culture	France	France
Ontbo	Software Development/Cloud services	France	France
ONWARD® Medical	Health	Netherlands	
ONYXIA	Software Development/Cloud services	France	France
OORION	Personal Services	France	France
Opale	Software Development/Cloud services	France	France
OpencyberAI	Cybersecurity/Defense	United Kingdom	
OpenDecide	Software Development/Cloud services	France	France
Openforet	Information technologies	France	France
OpenRep.ai	Marketing/Advertising/Communication	Canada	
Opteamis	Consulting	France	France
Optel	Industry	Canada	
OPTIMAL RH	HR/Training/Education	New Caledonia	
Optimmo	Energy	France	France
Optiwise	Cybersecurity/Defense	France	France
Ora	Media/Entertainment/Culture	France	France
Orakl Oncology	Health	France	France
ORANGE	Telecom/Connectivity	France	France
Orbina AI	Software Development/Cloud services	Turkey	
ORCAUBOAT	Mobility/Transportation	China	
Ordalie AI	Information technologies	France	France
ORIS Materials Intelligence	Mobility/Transportation	France	France
ORLIB Limited	Energy	Japan	
Orosound	Industry	France	France
OrthographIQ	HR/Training/Education	France	France
OryLab	HR/Training/Education	Japan	
Otowahr Inc.	Information technologies	Taiwan	
OUAT!	Software Development/Cloud services	Belgium	
Outalma	Consumer goods/Retail/E-commerce	Senegal	
OUTEX	Health	Ukraine	
Outmind	Software Development/Cloud services	France	France
Outmind	Information technologies	France	France
Outmind	Software Development/Cloud services	France	France
OUTPUT & BOE	Media/Entertainment/Culture	China	
Outsight	Software Development/Cloud services	France	France
OVA	HR/Training/Education	Canada	
Ovochain	Information technologies	France	France
Oxia Palus	Media/Entertainment/Culture	United Kingdom	
P1sec	Cybersecurity/Defense	France	France
P4S	Cybersecurity/Defense	France	France
PACKTIC - RetailTech	Consumer goods/Retail/E-commerce	France	France
PageProof	Marketing/Advertising/Communication	New Zealand	
Palmear	Information technologies	Jordan	
PanelSemi Corporation	Marketing/Advertising/Communication	Taiwan	
PanopticAI Limited	Health	Hong Kong	
panthr healthtech	Health	Germany	
Papkot	Other	France	France
Parados	Health	Canada	
PARALLEL 14	HR/Training/Education	France	France
PARCOURS PARENTHESE	HR/Training/Education	France	France
PARENCY	Health	France	France
Paris Saclay Campus Cancer	Health	France	France
ParkPilot	Mobility/Transportation	Ghana	
Pasqal	Other	France	France
Pasqal	Other	France	France
Pasqal	Other	France	France
Pasqal	Other	France	France
Pâtatra	Food	France	France
Patently	Software Development/Cloud services	United Kingdom	
Pathway	Information technologies	France	France
Pave Motors	Mobility/Transportation	United States of America	
Payps	Marketing/Advertising/Communication	France	France
payware	Banking/Finance/Insurance/Legal	Bulgaria	
PEEKCELL	Health	France	France
PEEL Lab K.K.	Other	Japan	
Peelo	Other	Senegal	
Pelican Cycles	Mobility/Transportation	France	France
Pelico	Software Development/Cloud services	France	France
People In	HR/Training/Education	France	France
People In	HR/Training/Education	France	France
PeopleSpheres	HR/Training/Education	France	France
PeopleYou	HR/Training/Education	France	France
PEP ITS	Health	France	France
Perception Manufacturing	Industry	France	France
Perfect Corp	Software Development/Cloud services	Taiwan	
Perfect Doc Studio	Software Development/Cloud services	Canada	
PERFECTPOST	Marketing/Advertising/Communication	France	France
Perfitt	Software Development/Cloud services	South Korea	
Perifit	Consumer goods/Retail/E-commerce	France	France
PeriVision	Health	Switzerland	
Perspectives.pm (by IO.LAND)	Information technologies	Belgium	
PESS Energy	Energy	France	France
PETCLUB	Other	France	France
Petnow Inc.	Software Development/Cloud services	South Korea	
PEUGEOT	Mobility/Transportation	France	France
Pharmatch	Health	France	France
Philippe AUDUBERT	Food	France	France
Phoenix AI	Mobility/Transportation	Belgium	
PHOENIX BLOCK 3	Media/Entertainment/Culture	France	France
Phygitix	Marketing/Advertising/Communication	France	France
Phyling	Other	France	France
Phytonics	Energy	Germany	
Pictia	Media/Entertainment/Culture	France	France
PIERREPLUME	Industry	France	France
PIESHIP	Consumer goods/Retail/E-commerce	Saudi Arabia	
Pigment	Software Development/Cloud services	France	France
PimpUp	Consumer goods/Retail/E-commerce	France	France
Pingprice	Consumer goods/Retail/E-commerce	Belgium	
PinMy	Marketing/Advertising/Communication	Ukraine	
PiTangent Analytics & Technology	Information technologies	India	
Pitchboy	HR/Training/Education	France	France
PITCHY	Software Development/Cloud services	France	France
PixelFree Studio	Software Development/Cloud services	Germany	
Pixelity Inc.	Software Development/Cloud services	South Korea	
Pixii Motors	Mobility/Transportation	France	France
PIXSTART	Consulting	France	France
Platform.sh	Information technologies	France	France
Plentify	Energy	South Africa	
Plume	Mobility/Transportation	France	France
PMY Group	Information technologies	Australia	
Pocket RD Inc.	Software Development/Cloud services	Japan	
Pocketalk Corporation	Information technologies	Japan	
Pockyt	Banking/Finance/Insurance/Legal	United States of America	
POLARHIS-SICARDI	Government/Public institutions	France	France
Pôle Action Media		France	France
Pollen	HR/Training/Education	France	France
PolyAI	Software Development/Cloud services	United Kingdom	
Pomelo Factory	Marketing/Advertising/Communication	France	France
Popsell	Consumer goods/Retail/E-commerce	France	France
Popsink	Information technologies	France	France
Portugal - AICEP Portugal Global	Government/Public institutions	Portugal	
POSITHÔT the Antimatter Manufacture	Industry	France	France
POST INDUSTRIAL CRAFTS	Smart City/Building	France	France
POSTUMO	Banking/Finance/Insurance/Legal	New Zealand	
POWANDGO SRL	Mobility/Transportation	Italy	
Powea	Mobility/Transportation	Turkey	
Power Genius GmbH______	Industry	China	
Power Up	Software Development/Cloud services	France	France
POWER.xyz	Luxury/Fashion/Beauty	France	France
Powerdot	Mobility/Transportation	France	France
PowerShield Limited	Information technologies	New Zealand	
Praesens	Health	France	France
Preligens	Cybersecurity/Defense	France	France
Preply Business	HR/Training/Education	United States of America	
PricingHUB	Software Development/Cloud services	France	France
PRILANCE	HR/Training/Education	Senegal	
Primaa	Health	France	France
Private AI	Software Development/Cloud services	Canada	
Probabl.	Software Development/Cloud services	France	France
PRODAFT	Cybersecurity/Defense	Netherlands	
Prodrone Co., Ltd.	Cybersecurity/Defense	Japan	
PROES	Telecom/Connectivity	France	France
Progress Magic	Software Development/Cloud services	Singapore	
Promova	HR/Training/Education	Ukraine	
Pruna AI	Information technologies	Germany	
PUBLICIS GROUPE	Marketing/Advertising/Communication	France	France
Pudu Robotics Co., Ltd ______	Industry	China	
PULPOAR INC	Luxury/Fashion/Beauty	United States of America	
Pulse Audition	Health	France	France
PURPL	Other	France	France
Purple Alternative Surface	Industry	France	France
Purse	Banking/Finance/Insurance/Legal	France	France
PwC	Consulting	France	France
PWN & PATCH	Cybersecurity/Defense	France	France
pyannote AI	Information technologies	France	France
Q°EMOTION	Marketing/Advertising/Communication	France	France
Qair	Energy	France	France
QAIRNEL	Health	France	France
Qairnel / Dr Memo	Health	France	France
QANSWER by The QA Company	Software Development/Cloud services	France	France
Qareeb	Software Development/Cloud services	Algeria	
Qarnot Computing	Software Development/Cloud services	France	France
QbitSoft	Information technologies	France	France
QBranch	Other	France	France
Qevlar AI	Cybersecurity/Defense	France	France
Qias Technologie	Industry	Algeria	
Qode Limited	Information technologies	United Arab Emirates	
Qolaig	Information technologies	France	France
QOOXY	Consumer goods/Retail/E-commerce	Algeria	
QPerfect	Software Development/Cloud services	France	France
QPMind	Health	Netherlands	
Qruise	Information technologies	Germany	
Qruise GmbH	Information technologies	Germany	
QUALISTEO	Energy	France	France
Quandela	Other	France	France
Quantexa	Information technologies	United Kingdom	
QuantiHealth	Health	France	France
QuantPi GmbH	Software Development/Cloud services	Germany	
QUATRE FEVRIER	Health	France	France
Qubit Pharmaceuticals	Health	France	France
QUESTIT S.R.L	Information technologies	Italy	
Quid	Software Development/Cloud services	United States of America	
QUIDEOS	Banking/Finance/Insurance/Legal	France	France
QUIVIVE-App by VDP 3.0	Personal Services	France	France
Quobly	Information technologies	France	France
QUOS Group	Smart City/Building	France	France
Quotelo Benelux	Hospitality/Tourism/Travel	Belgium	
R2Devops	Cybersecurity/Defense	France	France
R3	Consulting	France	France
R3D	Industry	France	France
Rabo Identity Services	Other	Netherlands	
Rafeeg	Consumer goods/Retail/E-commerce	United Arab Emirates	
Rafinex	Cybersecurity/Defense	Luxembourg	
RAIKU Packaging OÜ	Industry	Estonia	
Raive	Information technologies	United States of America	
Ranictek Inc.	Telecom/Connectivity	Taiwan	
Rapidata AG	Software Development/Cloud services	Switzerland	
Raptor Maps	Energy	United States of America	
Rayn	Banking/Finance/Insurance/Legal	France	France
RDS	Health	France	France
Rea Diagnostics SA	Health	Switzerland	
Reality Academy	HR/Training/Education	France	France
RECON Labs	Software Development/Cloud services	South Korea	
RecyclageVR (by VRAI Studio)	HR/Training/Education	France	France
Reebike	Mobility/Transportation	France	France
Reebirth	Consumer goods/Retail/E-commerce	France	France
ReelSights AI	Media/Entertainment/Culture	Hong Kong	
REEV	Health	France	France
REFACT	Industry	France	France
Refact.ai	Software Development/Cloud services	United Kingdom	
Reflextime company	Health	France	France
Region Auvergne-Rhône-Alpes	Government/Public institutions	France	France
Region Centre-Val de Loire	Government/Public institutions	France	France
Region Île-de-France / Paris Region	Government/Public institutions	France	France
Region Normandie	Non Profit	France	France
Region Nouvelle-Aquitaine	Government/Public institutions	France	France
Region Occitanie - AD'OCC	Government/Public institutions	France	France
Region Pays de la Loire	Government/Public institutions	France	France
Region Reunion	Government/Public institutions	Reunion	
Region Sud	Government/Public institutions	France	France
REGIS MOTORS	Mobility/Transportation	Italy	
Regtitude Limited	Banking/Finance/Insurance/Legal	Hong Kong	
REHASAKU Co., Ltd	Health	Japan	
Releaf Paper	Consumer goods/Retail/E-commerce	Ukraine	
reLi Energy	Energy	Germany	
Remal IoT	Industry	United Arab Emirates	
Rematch	Media/Entertainment/Culture	France	France
renouvo	Consumer goods/Retail/E-commerce	Taiwan	
Republique de Cote d'Ivoire	Government/Public institutions	Cote d’Ivoire	
Request Finance	Banking/Finance/Insurance/Legal	France	France
Research PIECES	Health	France	France
Reseau SATT	Government/Public institutions	France	France
Reservble	Hospitality/Tourism/Travel	Ukraine	
RESOLVING RED	Smart City/Building	France	France
RestHero	Consumer goods/Retail/E-commerce	United Arab Emirates	
Retail & Logistics Park	Consumer goods/Retail/E-commerce	France	France
RetinaScope	Health	Netherlands	
Retras	Health	France	France
Reutec	Mobility/Transportation	France	France
REUTEC SOLUTIONS	Mobility/Transportation	France	France
Revela Systems	Software Development/Cloud services	Canada	
REVENT	Information technologies	United Arab Emirates	
Revers.io	Software Development/Cloud services	France	France
Revival Bionics	Health	France	France
RevoAI GmbH	Industry	Germany	
Revolty	Energy	France	France
REVYVE Technologies	Mobility/Transportation	Germany	
Rexplorer	Energy	Estonia	
REYOUZZ	Consumer goods/Retail/E-commerce	France	France
Reyouzz	Consumer goods/Retail/E-commerce	France	France
REYOUZZ 1	Consumer goods/Retail/E-commerce	France	France
REZEAU CONSTRUCTEUR EOLIEN	Smart City/Building	France	France
Rhoban	Other	France	France
Ridergy	Energy	Germany	
Rightnow-by-Brenco	Information technologies	Algeria	
RIIICO GmbH	Industry	Germany	
Rime Bioinformatics	Health	France	France
Ringover	Software Development/Cloud services	France	France
RIOT	Information technologies	France	France
Riseup Labs	Information technologies	Bangladesh	
Riskfuel Analytics Inc.	Banking/Finance/Insurance/Legal	Canada	
RIVIeRE YUAN EDTECH	HR/Training/Education	France	France
RIZER.CLICK	Consumer goods/Retail/E-commerce	France	France
Roamigo	Telecom/Connectivity	South Korea	
Robosen Robotics	Consumer goods/Retail/E-commerce	China	
RockFish	Information technologies	United States of America	
Rofim	Health	France	France
Rology	Health	Egypt	
ROMIN	Government/Public institutions	France	France
ROSE PIRATE	Luxury/Fashion/Beauty	France	France
Roundpeg	Industry	Germany	
RUN.EDGE	Media/Entertainment/Culture	Japan	
RunBlind	Information technologies	France	France
RUNTECH SERVICES	Smart City/Building	Reunion	
Saarland Innovation & Standort	Government/Public institutions	Germany	
SABI AGRI	Food	France	France
SafeBrain.AI	Software Development/Cloud services	France	France
Safehear	Industry	France	France
Saga	Information technologies	Bulgaria	
Sakowin	Energy	France	France
SALESFORCE	Software Development/Cloud services	United States of America	
SAMP	Software Development/Cloud services	France	France
Sanofi	Health	France	France
SANPOM powered by Nuvatech.me	Consumer goods/Retail/E-commerce	China	
SARL ATLAS MARKET SPACE	Software Development/Cloud services	Algeria	
SARL BIT BAIT ALGERIE	Industry	Algeria	
SARL CAFYB	Software Development/Cloud services	Algeria	
SARL MERID TECHNOLOGY	Information technologies	Algeria	
SARL VIVALTECH	Cybersecurity/Defense	Algeria	
SARL ZIMOU EXPRESS	Software Development/Cloud services	Algeria	
Sas innotech - Greenfib	Industry	France	France
SAS Les truffieres du Berry	Food	France	France
SAS MONDIN - NISIAR	Luxury/Fashion/Beauty	France	France
Satisfai	Information technologies	Armenia	
Saudi Arabia - Saudi Federation for Cybersecurity, Programming and Drones	Cybersecurity/Defense	Saudi Arabia	
Save Innovations	Industry	France	France
Save Your Wardrobe	Luxury/Fashion/Beauty	France	France
SAVIAN BY BIOFLUFF	Luxury/Fashion/Beauty	France	France
SAYNA	HR/Training/Education	France	France
SCALE AI	Government/Public institutions	Canada	
Scaleway	Information technologies	France	France
Scaylab	Software Development/Cloud services	France	France
Scenario	Software Development/Cloud services	United States of America	
Scewo AG	Mobility/Transportation	Switzerland	
SCHOOLAB	Consulting	France	France
SCHOOLAP	HR/Training/Education	United Arab Emirates	
Schoolz	Mobility/Transportation	Egypt	
Science&Vie	Media/Entertainment/Culture	France	France
SciFunGames	Media/Entertainment/Culture	France	France
SCINTIL Photonics	Telecom/Connectivity	France	France
SCORP.IO SOFT	Industry	France	France
Screeb	Software Development/Cloud services	France	France
SCREENFLEX	Marketing/Advertising/Communication	Tunisia	
SEABEX SAS	Food	France	France
SEC-CURE	Information technologies	France	France
SecondSTAX	Banking/Finance/Insurance/Legal	Ghana	
SeedLegals	Banking/Finance/Insurance/Legal	France	France
Segmentify	Software Development/Cloud services	United Kingdom	
Selartag	Information technologies	France	France
SELEXPERT	Government/Public institutions	France	France
Selinko	Luxury/Fashion/Beauty	Belgium	
Semactic	Marketing/Advertising/Communication	Belgium	
Semeia	Health	France	France
Sendra	Mobility/Transportation	Senegal	
Sendyo	Mobility/Transportation	Algeria	
Senmixmaster	Media/Entertainment/Culture	Senegal	
SENT	Mobility/Transportation	Saudi Arabia	
SENTRIC	Consumer goods/Retail/E-commerce	Italy	
SeqOne	Health	France	France
Serafim	Media/Entertainment/Culture	Taiwan	
Sereema	Energy	France	France
Serial Founders	Software Development/Cloud services	Germany	
Sesame	Software Development/Cloud services	Germany	
Seturon	HR/Training/Education	Luxembourg	
SEV_	Smart City/Building	France	France
SeveUp	Software Development/Cloud services	France	France
SEWTOO	Consumer goods/Retail/E-commerce	France	France
Seyna	Software Development/Cloud services	France	France
Sezame	Hospitality/Tourism/Travel	France	France
Sezame	Banking/Finance/Insurance/Legal	France	France
SFEIRA	Information technologies	France	France
SG Wireless Limited	Telecom/Connectivity	Hong Kong	
SGLAB	Information technologies	South Korea	
Shape Eat	Food	France	France
SHAPE EAT	Food	France	France
SHAREID	Cybersecurity/Defense	France	France
SHAREKEY Swiss AG	Cybersecurity/Defense	Switzerland	
Shares	Banking/Finance/Insurance/Legal	France	France
Shayp	Smart City/Building	Belgium	
SHB - KADALYS	Luxury/Fashion/Beauty	France	France
Shelvz	Consumer goods/Retail/E-commerce	Lebanon	
Shengyide intelligent Technology	Industry	China	
Shenzhen TOALL Technology ______	Information technologies	China	
Shift Technology	Software Development/Cloud services	France	France
SHIFT89	HR/Training/Education	France	France
Ship+Tag	Consumer goods/Retail/E-commerce	Saudi Arabia	
Shoplazza (____)	Information technologies	China	
ShopmeAway	Consumer goods/Retail/E-commerce	Senegal	
Shwett	Information technologies	France	France
Sia Partners	Consulting	Canada	
SID SRL	Media/Entertainment/Culture	Italy	
SIEMENS	Other	Germany	
Sifted	Media/Entertainment/Culture	United Kingdom	
SilMach	Other	France	France
SIM2REAL	Software Development/Cloud services	korearepublicof	
Simplex	Software Development/Cloud services	Brazil	
SimplyAsk.ai	Information technologies	Canada	
Simularge Inc.	Software Development/Cloud services	Turkey	
Sino French Innovation Cooperation Acceleration Center (CAIC)	Government/Public institutions	China	
SIPEARL	Other	France	France
Siradel	Smart City/Building	France	France
Sirius Space Services	Mobility/Transportation	France	France
SISTA	Non Profit	France	France
Sit Up	Health	France	France
Skairos	Health	France	France
Skreenplay	Marketing/Advertising/Communication	France	France
Skreenplay	Hospitality/Tourism/Travel	France	France
SKWHEEL	Mobility/Transportation	France	France
Sky Meta Limited	Information technologies	Hong Kong	
Skyld	Cybersecurity/Defense	France	France
SKYLD	Cybersecurity/Defense	France	France
Skyline Digital	Banking/Finance/Insurance/Legal	Portugal	
Skyline Partners	Banking/Finance/Insurance/Legal	United Kingdom	
SKYPLE	Information technologies	France	France
Skyted	Mobility/Transportation	France	France
Skyted	Mobility/Transportation	France	France
Skyted	Mobility/Transportation	France	France
Sline	Consumer goods/Retail/E-commerce	France	France
SMART GAMES POTE&MATCH	Software Development/Cloud services	France	France
Smartbiotic	Health	France	France
Smarteyerobotics	Other	Algeria	
SMARTGOLF LLC	Media/Entertainment/Culture	United States of America	
smartindu GmbH & Co. KG	Industry	Germany	
Smartly.AI	Banking/Finance/Insurance/Legal	France	France
Smartpreuve	Banking/Finance/Insurance/Legal	France	France
SmartWTI	Smart City/Building	Jordan	
SMHAEL	Luxury/Fashion/Beauty	South Korea	
SmileRepair	Telecom/Connectivity	France	France
Snowflake	Software Development/Cloud services	United States of America	
Snowpack	Cybersecurity/Defense	France	France
So Sponge	Industry	France	France
SOCAPHARM	Health	Cote d’Ivoire	
Societe d'Application de Peinture	Smart City/Building	France	France
SOCIETE GENERALE	Banking/Finance/Insurance/Legal	France	France
Socium	HR/Training/Education	Senegal	
Sofcle co.,Ltd	Health	South Korea	
SOFRIGAM GROUP	Industry	France	France
Soft Kids	HR/Training/Education	France	France
Software Republique	Mobility/Transportation	France	France
SOFY	Marketing/Advertising/Communication	France	France
Solar Dev	Energy	Burkina Faso	
Solar Impulse Fondation	Non Profit	Switzerland	
SOLAR-PAINT	Energy	France	France
SOLARCUB	Industry	France	France
Solid State of Mind Inc.	Information technologies	Canada	
SolInjection	Banking/Finance/Insurance/Legal	France	France
SOLLYS	Energy	France	France
SOLSIUS	Health	France	France
SOLUTION AIR BV	Mobility/Transportation	Netherlands	
Someware	Mobility/Transportation	France	France
Sonaide	Health	France	France
Sonaide	Health	France	France
Sonceboz	Mobility/Transportation	Switzerland	
Sonio	Health	France	France
Sonup	Health	France	France
SOOTENIR	HR/Training/Education	France	France
Sopht	Information technologies	France	France
SOPRA STERIA	Information technologies	France	France
SORA Technology	Health	Japan	
SORAMITSU	Information technologies	Japan	
Sorcova Health	Health	France	France
Sorella Care	Health	France	France
Sorore	Health	France	France
SOUKI	Energy	Algeria	
SoundHound AI	Software Development/Cloud services	United States of America	
SOUNDUCT	Health	France	France
Sourcery	Software Development/Cloud services	United Kingdom	
SP80	Other	Switzerland	
Space Entertainment Laboratory	Other	Japan	
Sparkneo	Marketing/Advertising/Communication	France	France
Sparkup	Software Development/Cloud services	France	France
Speakly AI	Information technologies	United States of America	
SPECTROO SOFTWARE	Marketing/Advertising/Communication	Romania	
Spendesk	Banking/Finance/Insurance/Legal	France	France
SPHENO ID	HR/Training/Education	Monaco	
SpiNNcloud	Information technologies	Germany	
SpiNNcloud Systems	Information technologies	Germany	
Spiral Inc.	Industry	Japan	
Spoki	Marketing/Advertising/Communication	Italy	
SporTech Fr	Non Profit	France	France
Sporty Peppers	Media/Entertainment/Culture	France	France
Sportyneo	Banking/Finance/Insurance/Legal	France	France
SPORTYPLAY	Media/Entertainment/Culture	France	France
Spotium GmbH	Industry	Germany	
Spotr	Information technologies	Netherlands	
SQ-MOTORS	Mobility/Transportation	France	France
SQUAREMIND	Health	France	France
SRDI (_______)	Government/Public institutions	China	
ST DIGITAL	Software Development/Cloud services	Cameroon	
STABL Energy	Energy	Germany	
Stackease	Energy	France	France
Stancer	Banking/Finance/Insurance/Legal	France	France
STARTMINING	Other	France	France
Startup For Kids	HR/Training/Education	France	France
Startup Luxembourg	Government/Public institutions	Luxembourg	
Startup Portugal	Government/Public institutions	Portugal	
Startups Magazine	Media/Entertainment/Culture	United Kingdom	
STAYFLUENCE	Marketing/Advertising/Communication	France	France
STEERLIGHT	Mobility/Transportation	France	France
Stellar	Cybersecurity/Defense	France	France
Stellar Telecommunications SAS	Telecom/Connectivity	France	France
Stellia	HR/Training/Education	France	France
Stellr	Software Development/Cloud services	United Arab Emirates	
STEMIR	Consumer goods/Retail/E-commerce	France	France
STEREOGRAPH	Smart City/Building	France	France
STOLECT	Energy	France	France
Stonedrum	Media/Entertainment/Culture	France	France
Storio Energy	Energy	France	France
Storyfox	Marketing/Advertising/Communication	France	France
Strapp Mobile	Telecom/Connectivity	France	France
Strategies	Media/Entertainment/Culture	France	France
Stratolia	Industry	France	France
StreetNav	Smart City/Building	France	France
StreetRacket	Health	Switzerland	
Striemo Inc.	Industry	Japan	
Stripe	Banking/Finance/Insurance/Legal	Ireland	
Strivee	Software Development/Cloud services	France	France
STROMDAO	Energy	Germany	
StrutFit	Consumer goods/Retail/E-commerce	New Zealand	
Stryza	Software Development/Cloud services	Germany	
Studio Artera	Media/Entertainment/Culture	France	France
Studio Imaqa	Marketing/Advertising/Communication	Spain	
Studio Nyx	HR/Training/Education	France	France
StyleBot	Consumer goods/Retail/E-commerce	South Korea	
STYLY, Inc.	Information technologies	Japan	
Sublimed	Health	France	France
Substance Of Light®	Luxury/Fashion/Beauty	France	France
Subworx	Information technologies	Germany	
Suena	Energy	Germany	
SUEZ	Other	France	France
Sun-Ways	Energy	Switzerland	
SUNNY SHARK	Smart City/Building	France	France
Sunology	Energy	France	France
SUPERCONNECTR	Software Development/Cloud services	France	France
Supernote	Consumer goods/Retail/E-commerce	France	France
Supervizor	Software Development/Cloud services	France	France
Supponor	Software Development/Cloud services	France	France
SurFunction GmbH	Industry	Germany	
sustamize GmbH	Software Development/Cloud services	Germany	
Sweep	Software Development/Cloud services	France	France
Sweep		France	France
Sweetch Energy	Energy	France	France
Swish Live	Media/Entertainment/Culture	France	France
swisstech	Government/Public institutions	Switzerland	
Switch ESS	Energy	France	France
Sylcast	Other	Japan	
SYNEGRAM.COM	Media/Entertainment/Culture	France	France
SYNK - THE PACK	Media/Entertainment/Culture	Belgium	
Synovance	Luxury/Fashion/Beauty	France	France
SYNTHESIA	HR/Training/Education	United Kingdom	
Synthesized	Banking/Finance/Insurance/Legal	United Kingdom	
Synthia	Information technologies	France	France
SYSTNAPS	Software Development/Cloud services	France	France
Tafalgie Therapeutics	Health	France	France
TAILOOR	Software Development/Cloud services	Italy	
Taiwan Tech Arena (TTA)	Government/Public institutions	Taiwan	
Takalam	Health	United Arab Emirates	
Take[air]	Energy	France	France
Tale Of Data	Information technologies	France	France
TALKR.ai	Software Development/Cloud services	France	France
TAMBA LABS	Health	France	France
Tanjiblocks	Media/Entertainment/Culture	France	France
TANN	Media/Entertainment/Culture	Martinique	
TAO Performance	Energy	France	France
Tawqi3i	Software Development/Cloud services	Jordan	
TBM Co., Ltd.	Industry	Japan	
Tchao Tchao	Mobility/Transportation	France	France
TD Synnex			
Tech4Eva Global Femtech Accelerator	Health	Switzerland	
Tech4Eva Global Femtech Accelerator	Health	Switzerland	
TechCare	Health	Jordan	
TECHKARE	Industry	France	France
Techmology	HR/Training/Education	Algeria	
Technis	Software Development/Cloud services	Switzerland	
Technische Universität München German-French Academy for the Industry of the Future	Government/Public institutions	Germany	
TechnoCarbon	Industry	France	France
TechnoCarbon	Industry	France	France
TECHNOPOLE I-NOVA GUADELOUPE	Non Profit	Guadeloupe	
Techsun	Information technologies	China	
TEED UP	Personal Services	France	France
TEED UP	Personal Services	France	France
TEENFLO	Health	France	France
TEEO	Energy	Reunion	
TELEPORT	Media/Entertainment/Culture	Hong Kong	
Teleport IN	Health	France	France
Telerik Academy	HR/Training/Education	Bulgaria	
Televet	Health	France	France
TEMEOO	Health	France	France
TEMS	Media/Entertainment/Culture	France	France
Tenchijin, Inc.	Software Development/Cloud services	Japan	
Tended	Information technologies	United Kingdom	
TenderFacts	Software Development/Cloud services	France	France
TENNISNGO	Other	France	France
TERA MAROC TECHNOLOGIE	Industry	Morocco	
TERCIEL	Mobility/Transportation	New Caledonia	
Ternow	Mobility/Transportation	Germany	
Terralpha	Telecom/Connectivity	France	France
TERRAVIONICS	Food	Italy	
Terriflux	Software Development/Cloud services	France	France
Tesla	Energy	France	France
Testbirds	Other	Germany	
TESTEUM	Software Development/Cloud services	New Caledonia	
Textkernel	HR/Training/Education	Netherlands	
Tezos presented by Nomadic Labs	Software Development/Cloud services	France	France
TG0 - Touch Sensing Technology	Consumer goods/Retail/E-commerce	United Kingdom	
Thalia Psychotherapy	Health	Kenya	
The Elephant's Children	Media/Entertainment/Culture	France	France
The Good Hack	Other	France	France
THE GOOD SAMARITAN	Hospitality/Tourism/Travel	France	France
The Little Cat Co., Ltd.	Health	South Korea	
The Media Leader	Media/Entertainment/Culture	France	France
THE NEMESIS	Other	Italy	
The New Face	Media/Entertainment/Culture	France	France
The New York Times	Media/Entertainment/Culture	United States of America	
The Paac	Luxury/Fashion/Beauty	Italy	
THE SUITE ESCAPES	Hospitality/Tourism/Travel	France	France
The Surpluss	Other	United Arab Emirates	
The Washington Post	Media/Entertainment/Culture	United States of America	
TheCrossProduct	Mobility/Transportation	France	France
Theory and Practice	Consumer goods/Retail/E-commerce	Canada	
TheraSonic	Health	France	France
Thermalytica	Energy	Japan	
Think Nature Inc.	Consulting	Japan	
ThinNature		Japan	
Threedium	Software Development/Cloud services	United Kingdom	
ThrustMe	Mobility/Transportation	France	France
Thundersoft	Information technologies	China	
TI3RS	Telecom/Connectivity	France	France
TIBEKA PROTECTIONS	Industry	France	France
TICKEE	Software Development/Cloud services	French Polynesia	
TIDYUP TECHNOLOGIES	Software Development/Cloud services	France	France
Tilt	Energy	France	France
Time2Plug	Energy	France	France
TimelapseLab & Snapall	Information technologies	Italy	
Togg	Mobility/Transportation	Turkey	
Tokwise	Energy	Bulgaria	
Tokyo Metropolitan Government	Government/Public institutions	Japan	
TOLV	Mobility/Transportation	France	France
Tonomia eParking Solar	Energy	Belgium	
TOOG	Software Development/Cloud services	France	France
Tookano	Marketing/Advertising/Communication	France	France
Toothpick	Health	United Arab Emirates	
TOPORDER	Software Development/Cloud services	France	France
TOPPAN	Information technologies	Japan	
TORSKAL	Health	Reunion	
TotalEnergies	Energy	France	France
Touba Solution Informatique	Software Development/Cloud services	Senegal	
Toucan Toco	Software Development/Cloud services	France	France
Touch2See	Information technologies	France	France
Tourism IN	Hospitality/Tourism/Travel	France	France
TOUWI	Software Development/Cloud services	France	France
TOWING	Industry	Japan	
Trace For Good	Information technologies	France	France
Train your mind( TYM)	HR/Training/Education	Tunisia	
Train.Red B.V.	Health	Netherlands	
TrainMe	Health	France	France
Trajaan	Software Development/Cloud services	France	France
Transformers Academy	HR/Training/Education	Canada	
trawa	Energy	Germany	
Treesition	Banking/Finance/Insurance/Legal	France	France
TRENDEX	Marketing/Advertising/Communication	France	France
Triggers reports ltd	Software Development/Cloud services	Mauritius	
TRINANO TECHNOLOGIES PVT LTD	Energy	India	
TRIPARTIE	Consumer goods/Retail/E-commerce	France	France
Triplet	Software Development/Cloud services	South Korea	
Troov	Information technologies	France	France
Trout Software	Information technologies	France	France
True Tourism	Hospitality/Tourism/Travel	France	France
Trueffles	Media/Entertainment/Culture	Germany	
Trustineo	Consumer goods/Retail/E-commerce	Cote d’Ivoire	
Trusting Pixels Inc.	Software Development/Cloud services	Canada	
Trustlens	Cybersecurity/Defense	Germany	
Trustwise AI	Software Development/Cloud services	United States of America	
TRUXAT	Industry	Saudi Arabia	
TRYO Virtual Try-On Technologies	Information technologies	Turkey	
TSGC Technologies Inc.	Other	Taiwan	
TTC Global	Information technologies	New Zealand	
TUC.technology	Mobility/Transportation	Italy	
TUITO - Voice Interaction	Information technologies	France	France
Tukkijamm	Mobility/Transportation	Senegal	
tulana	Industry	Germany	
Tunisie - Ministry of Communication Technologies	Information technologies	Tunisia	
TURN2X	Energy	Germany	
Turpal Technologies	Hospitality/Tourism/Travel	United Arab Emirates	
Twinical	Health	France	France
TWINSWHEEL	Mobility/Transportation	France	France
Tyba	Energy	United States of America	
Typeface	Information technologies	United States of America	
U-fast	Health	France	France
UA GREEN	Energy	Ukraine	
UAB DeRISK Business Solutions	Banking/Finance/Insurance/Legal	Lithuania	
UAE  Ministry of Economy	Government/Public institutions	United Arab Emirates	
UATE	Non Profit	Armenia	
Ubestream Inc.	Information technologies	Taiwan	
Ubitus K.K.	Software Development/Cloud services	Taiwan	
Ublo	Software Development/Cloud services	France	France
uCloudlink Group Inc.	Telecom/Connectivity	Singapore	
UDENZ	Health	United Arab Emirates	
Ukraine - Ambassade d'Ukraine	Government/Public institutions	Ukraine	
Ultrahaus Venture Studio	Software Development/Cloud services	Canada	
UMAY	Information technologies	France	France
UMAY	Smart City/Building	France	France
uMotion	Mobility/Transportation	France	France
Unboared	Media/Entertainment/Culture	France	France
UncovAI	Information technologies	France	France
Underate	Banking/Finance/Insurance/Legal	France	France
UNIFOX	Banking/Finance/Insurance/Legal	France	France
Uniigym	Health	Taiwan	
United Heroes	Software Development/Cloud services	France	France
United Heroes	Software Development/Cloud services	France	France
United Robotics Group	Industry	Germany	
UNITED SILK CO., LTD.	Luxury/Fashion/Beauty	Japan	
Unitree Robotics	Consumer goods/Retail/E-commerce	China	
Universite Paris-Saclay	Government/Public institutions	France	France
UNO INDUSTRY		Algeria	
Unseenlabs	Cybersecurity/Defense	France	France
UNVOID	Smart City/Building	France	France
UP&CHARGE	Mobility/Transportation	France	France
UPEAK	Health	France	France
UPEAK	Health	France	France
UPIKAJOB	HR/Training/Education	France	France
Upply	Mobility/Transportation	France	France
Upstream Tech	Other	United States of America	
Uptale	HR/Training/Education	France	France
Uptale	Software Development/Cloud services	France	France
Uptale	HR/Training/Education	France	France
UPTALE	HR/Training/Education	France	France
Urban Linker	HR/Training/Education	France	France
Urban Radar	Smart City/Building	France	France
URBANOMY (EDF GROUP)	Consulting	France	France
Usense	Health	France	France
UUUUU	Consumer goods/Retail/E-commerce	korearepublicof	
UUUUU Inc.	Consumer goods/Retail/E-commerce	korearepublicof	
V BIOTECH (V.E.R.A)	Consumer goods/Retail/E-commerce	France	France
V-Event	Marketing/Advertising/Communication	France	France
V-Event	Marketing/Advertising/Communication	France	France
V-Labs	Information technologies	Switzerland	
V.RTU	Other	France	France
VALKUREN	Software Development/Cloud services	Belgium	
Valoon	Smart City/Building	Germany	
Valoriz'me	Food	France	France
Value Park	Energy	France	France
ValueWorks GmbH	Software Development/Cloud services	Germany	
Vaultys	Cybersecurity/Defense	France	France
VCAST	Information technologies	France	France
Vect-Horus	Health	France	France
Veebya	Personal Services	France	France
Veesual	Luxury/Fashion/Beauty	France	France
Veeton	Luxury/Fashion/Beauty	France	France
Veeton	Luxury/Fashion/Beauty	France	France
Veeve Inc	Consumer goods/Retail/E-commerce	United States of America	
Vegetal Signals	Information technologies	France	France
VeloCertifie.com	Mobility/Transportation	France	France
Velocity Tech	Consulting	United Kingdom	
Vendee soft	HR/Training/Education	France	France
VenueX	Information technologies	Turkey	
Verbalia	Software Development/Cloud services	France	France
Verdikt	Information technologies	France	France
Verdikt	Information technologies	France	France
Verizon Business	Telecom/Connectivity	France	France
Versori	Software Development/Cloud services	United Kingdom	
Vertuoso	Other	France	France
Vertuoso	Other	France	France
VERTUOZ BY ENGIE SOLUTIONS	Energy	France	France
VIALINK	Banking/Finance/Insurance/Legal	France	France
Vianeo	Consulting	France	France
VIBES	Personal Services	France	France
Vibiscus	Industry	France	France
Videns Analytics	Information technologies	Canada	
Video Prod	Information technologies	France	France
Videobot	Marketing/Advertising/Communication	Luxembourg	
Videolinq	Software Development/Cloud services	Canada	
VIDETICS	Smart City/Building	France	France
Viqthor	Telecom/Connectivity	France	France
VIRGOMOVE	Mobility/Transportation	France	France
Virteem	Software Development/Cloud services	France	France
VirtualSociety	Media/Entertainment/Culture	France	France
Vision Intelligence Co., Ltd.	Consumer goods/Retail/E-commerce	China	
Visionerves	Health	France	France
VisionFlow	Information technologies	United States of America	
VISIOON	Software Development/Cloud services	New Caledonia	
Visuall	Marketing/Advertising/Communication	France	France
Vitafluence.ai	Health	Germany	
Vitesse Automation	Information technologies	France	France
Vitichar	Other	France	France
Vitirover SAS	Energy	France	France
Viva After Work by Radio FG	Media/Entertainment/Culture	France	France
VIVERSE by HTC	Software Development/Cloud services	Ireland	
Vivoo	Health	Turkey	
Vivre Et Travailler Autrement	Non Profit	France	France
VizitAR	Hospitality/Tourism/Travel	Portugal	
VKARD	Marketing/Advertising/Communication	France	France
VO2 GROUP	Consulting	France	France
Vocads	Information technologies	France	France
VOCIC ______	Health	China	
VOCSens	Information technologies	Belgium	
Vodar	Other	Bulgaria	
VOGO	Software Development/Cloud services	France	France
VOICEME S.r.l.	Cybersecurity/Defense	Italy	
Voila	Software Development/Cloud services	France	France
Vokse	Information technologies	France	France
Volocopter GmbH	Mobility/Transportation	Germany	
Voltaage	Energy	France	France
VoltR	Industry	France	France
Voltraware Semiconductor Co. Ltd.	Mobility/Transportation	Taiwan	
Volucap	Media/Entertainment/Culture	Germany	
Vooban	Software Development/Cloud services	Canada	
Voxist	Information technologies	France	France
VOXYMORE	Information technologies	France	France
Voyagel	Mobility/Transportation	Senegal	
Voyey.com	Consumer goods/Retail/E-commerce	France	France
VRIJE UNIVERSITEIT BRUSSEL	Other	Belgium	
Vtouch, Inc.	Information technologies	South Korea	
Vulgaroo	Health	France	France
VusionGroup	Consumer goods/Retail/E-commerce	France	France
VVR Co., LTD.	HR/Training/Education	South Korea	
VYTAL	Food	France	France
W PLATFORM	Industry	France	France
WAAT	Mobility/Transportation	France	France
Wakatoon	Media/Entertainment/Culture	France	France
Walk	Personal Services	France	France
Wallonia.be / AWEX  (BELGIUM)	Government/Public institutions	Belgium	
WaltR		France	France
WASE	Other	United Kingdom	
Waspito	Health	Cameroon	
WasteAnt GmbH	Energy	Germany	
Wastetide	Software Development/Cloud services	France	France
Water Challenge SL	Industry	Spain	
water stuff & sun GmbH	Energy	Germany	
WaterSec (by Istidama)	Smart City/Building	Tunisia	
WATTALPS	Mobility/Transportation	France	France
WATTSGOOD	Other	France	France
Waveful	Media/Entertainment/Culture	Italy	
Wavelength Learning	HR/Training/Education	New Zealand	
WAVESTONE	Consulting	France	France
WD Protection - La Belle Absorbante	Health	France	France
we are_	Media/Entertainment/Culture	France	France
We Spot Turtles!	Other	France	France
WEAR SRL	Software Development/Cloud services	Italy	
Wearify	Luxury/Fashion/Beauty	Armenia	
WeatherMind	Banking/Finance/Insurance/Legal	France	France
WebCapsule	Software Development/Cloud services	France	France
WEBEDIA	Media/Entertainment/Culture	France	France
WeChooz	HR/Training/Education	France	France
Weenav	Mobility/Transportation	France	France
Weezevent	Media/Entertainment/Culture	France	France
Welcome Account	Banking/Finance/Insurance/Legal	France	France
Welinq	Information technologies	France	France
Well-being & Sports Park sponsored by Axa	Health	France	France
WeMaintain	Smart City/Building	France	France
WeMaintain	Smart City/Building	France	France
WeMaintain	Smart City/Building	France	France
Wemap	Information technologies	France	France
WEMAP	Information technologies	France	France
WEO	Smart City/Building	Luxembourg	
Wequity	Software Development/Cloud services	Belgium	
WeRoad	Hospitality/Tourism/Travel	Italy	
WESHAKE	Banking/Finance/Insurance/Legal	France	France
Wetri	Consumer goods/Retail/E-commerce	France	France
Wever	Software Development/Cloud services	France	France
WeWard	Health	France	France
WHAT THE FISH	Software Development/Cloud services	France	France
Whiffle	Energy	Netherlands	
WhiteLab Genomics	Health	France	France
Wi-Agric lab	Food	Sierra Leone	
WIGO	Mobility/Transportation	French Polynesia	
WIIDETECT	Industry	France	France
WILCO - Unleashing Ambition	Consulting	France	France
Wilkins Avenue AR	Consumer goods/Retail/E-commerce	France	France
Windlair	Mobility/Transportation	France	France
Winespace	Food	France	France
Wingcopter	Mobility/Transportation	Germany	
WinSide	HR/Training/Education	France	France
Winside Technology	Consulting	France	France
Wintics	Software Development/Cloud services	France	France
WINTICS	Mobility/Transportation	France	France
Wise-Integration	Industry	France	France
withVR	HR/Training/Education	Belgium	
Witty Works	HR/Training/Education	Switzerland	
Witty Works	HR/Training/Education	Switzerland	
Wivisites	Hospitality/Tourism/Travel	France	France
WiXar	HR/Training/Education	France	France
WIZY.IO	Information technologies	France	France
Women In Tech	Government/Public institutions	France	France
Wondershare	Software Development/Cloud services	Hong Kong	
Woodoo	Smart City/Building	France	France
Woosmap	Software Development/Cloud services	France	France
Work With Island	Industry	France	France
Worklife	HR/Training/Education	France	France
World Matcha Co Ltd  / Cuzen Matcha	Food	Japan	
Woven by Toyota	Mobility/Transportation	Japan	
Woyomali	Mobility/Transportation	Mali	
WP connect	Marketing/Advertising/Communication	France	France
Wright Brothers	Mobility/Transportation	South Korea	
WURE	Luxury/Fashion/Beauty	France	France
WUSA Smart Inc.	Information technologies	Taiwan	
xBloom	Consumer goods/Retail/E-commerce	United States of America	
XBTO	Banking/Finance/Insurance/Legal	United Arab Emirates	
Xeno App	Consumer goods/Retail/E-commerce	France	France
Xlab	Government/Public institutions	Netherlands	
XPDEEP	Information technologies	France	France
XPENG	Industry	France	France
XPerience Tecnologia	HR/Training/Education	Brazil	
XR Bootcamp	HR/Training/Education	Germany	
Xtramile	Software Development/Cloud services	France	France
XtreeE	Smart City/Building	France	France
XtreeE	Smart City/Building	France	France
XUND	Health	Austria	
XXII	Software Development/Cloud services	France	France
XXII	Software Development/Cloud services	France	France
XY Sense	Smart City/Building	Australia	
xydrobe	Marketing/Advertising/Communication	United Kingdom	
xydrobe	Marketing/Advertising/Communication	United Kingdom	
Yapu-k & Co	Hospitality/Tourism/Travel	France	France
YDISTRI	Consumer goods/Retail/E-commerce	Czech Republic	
Yeda	Health	Germany	
Yeji Data Lab	Software Development/Cloud services	Canada	
Yellosis INC.	Health	South Korea	
Yellow Way	Other	Netherlands	
Yneuro	Information technologies	France	France
Ynsect	Food	France	France
YOCUDA subsidiary of GLOBAL BLUE	Marketing/Advertising/Communication	France	France
YOMBZ	HR/Training/Education	France	France
Yometel Co., Ltd.	Consumer goods/Retail/E-commerce	Japan	
Yoo Soft	Software Development/Cloud services	France	France
Yoo Soft CIC	Software Development/Cloud services	France	France
YOOI	Information technologies	France	France
yoona.ai	Software Development/Cloud services	Germany	
Youngs Job	HR/Training/Education	France	France
Your Personnal Shopper	Luxury/Fashion/Beauty	Senegal	
YourArt	Media/Entertainment/Culture	France	France
YourCall.ai	Information technologies	France	France
YouScribe	Media/Entertainment/Culture	France	France
Yucca Labs	Information technologies	France	France
Yukai Engineering Inc.	Consumer goods/Retail/E-commerce	Japan	
YURE	Other	Guadeloupe	
YZR	Information technologies	France	France
Z-EMOTION	Luxury/Fashion/Beauty	South Korea	
ZAUBAR	Information technologies	Germany	
zblocks	Information technologies	United States of America	
ZC Rubber ______	Industry	China	
ZEENDOC	Information technologies	France	France
Zelros - The Insurance Copilot™	Banking/Finance/Insurance/Legal	France	France
Zelros - The Insurance Copilot™	Banking/Finance/Insurance/Legal	France	France
Zencey	Health	Cote d’Ivoire	
ZERO WATTHEURE	Energy	France	France
ZEST ME UP	HR/Training/Education	France	France
ZEZEDU corp	HR/Training/Education	South Korea	
Zilo Energie	Energy	France	France
ZJAST______	Government/Public institutions	China	
Zleenk EdTech	HR/Training/Education	Armenia	
Zoundream	Health	Switzerland	
ZuriMED Technologies AG	Health	Switzerland	
ZYON Helmets	Mobility/Transportation	Spain	